ballot box with check	â˜‘ï¸
full moon with face	ğŸŒ
cheese	ğŸŒ
moon	ğŸŒ
smiling moon	ğŸŒ
phase	ğŸŒ
full	ğŸŒ
sky	ğŸŒ
moonface	ğŸŒ
night	ğŸŒ
werewolves	ğŸŒ
monsters	ğŸŒ
anthropomorphic	ğŸŒ
face	ğŸŒ
smiley moon	ğŸŒ
spooky	ğŸŒ
flag for belarus	ğŸ‡§ğŸ‡¾
regional indicator symbol letters by	ğŸ‡§ğŸ‡¾
belarusian flag	ğŸ‡§ğŸ‡¾
vain	ğŸ©
miniature poodle	ğŸ©
dog	ğŸ©
sophisticated	ğŸ©
showy	ğŸ©
clip	ğŸ©
toy poodle	ğŸ©
standard poodle	ğŸ©
poodle	ğŸ©
black scissors	âœ‚ï¸
cutting	âœ‚ï¸
double vertical bar	â¸
light brown bicyclist	ğŸš´ğŸ¼
greek	â™ï¸
stars	â™ï¸
scorpius	â™ï¸
sign	â™ï¸
astrology	â™ï¸
scorpio	â™ï¸
scorpion	â™ï¸
constellation	â™ï¸
zodiac	â™ï¸
cruise	ğŸš¢
cruise ship	ğŸš¢
boat	ğŸš¢
ferry	ğŸš¢
ship	ğŸš¢
husk	ğŸŒ½
kernel	ğŸŒ½
popcorn	ğŸŒ½
stalk	ğŸŒ½
cob	ğŸŒ½
iowa	ğŸŒ½
ear	ğŸŒ½
food	ğŸŒ½
yellow	ğŸŒ½
maize	ğŸŒ½
corn	ğŸŒ½
ear of maize	ğŸŒ½
corn on the cob	ğŸŒ½
steam locomotive	ğŸš‚
locomotive	ğŸš‚
steam train	ğŸš‚
railway locomotive	ğŸš‚
steam	ğŸš‚
train	ğŸš‚
engine	ğŸš‚
flag for british indian ocean territory	ğŸ‡®ğŸ‡´
british indian ocean territory flag	ğŸ‡®ğŸ‡´
negative squared latin capital letter o	ğŸ…¾ï¸
light brown bath	ğŸ›€ğŸ¼
flag for denmark	ğŸ‡©ğŸ‡°
regional indicator symbol letters dk	ğŸ‡©ğŸ‡°
taco	ğŸŒ®
flag for rwanda	ğŸ‡·ğŸ‡¼
regional indicator symbol letters rw	ğŸ‡·ğŸ‡¼
officer	ğŸš“
police	ğŸš“
cop car	ğŸš“
side of police car	ğŸš“
police car	ğŸš“
car	ğŸš“
ticket	ğŸš“
citation	ğŸš“
help	ğŸš“
crime	ğŸš“
emergency	ğŸš“
chicken drumstick	ğŸ—
poultry	ğŸ—
turkey leg	ğŸ—
chicken	ğŸ—
leg	ğŸ—
fried	ğŸ—
poultry leg	ğŸ—
female	ğŸ‘©
yellow woman	ğŸ‘©
lady	ğŸ‘©
woman	ğŸ‘©
deeper brown police officer	ğŸ‘®ğŸ¾
stars heart	ğŸ’–
sparkly heart	ğŸ’–
sparkle heart	ğŸ’–
sparkling heart	ğŸ’–
rock on	ğŸ¤˜
sign of the horns	ğŸ¤˜
devil fingers	ğŸ¤˜
heavy metal	ğŸ¤˜
large blue diamond	ğŸ”·
peel	ğŸŒ
banana	ğŸŒ
plantain	ğŸŒ
bunch	ğŸŒ
bag	ğŸ›…
left luggage	ğŸ›…
travel	ğŸ›…
baggage	ğŸ›…
luggage	ğŸ›…
heavy minus sign	â–
snowman	â˜ƒ
snowing snowman	â˜ƒ
couple with heart with two women	ğŸ‘©â€â¤ï¸â€ğŸ‘©
å‰²	ğŸˆ¹
bargain sale	ğŸˆ¹
kissing	ğŸ˜š
kiss face	ğŸ˜š
kissy face	ğŸ˜š
smooch	ğŸ˜š
kissing face with closed eyes	ğŸ˜š
love	ğŸ˜š
puckered	ğŸ˜š
passion	ğŸ˜š
heart	ğŸ˜š
kiss	ğŸ˜š
flag for malaysia	ğŸ‡²ğŸ‡¾
regional indicator symbol letters my	ğŸ‡²ğŸ‡¾
malaysian flag	ğŸ‡²ğŸ‡¾
chart with upwards trend	ğŸ“ˆ
cheese	ğŸŒ˜
moon	ğŸŒ˜
phase	ğŸŒ˜
waning	ğŸŒ˜
sky	ğŸŒ˜
night	ğŸŒ˜
waning crescent moon symbol	ğŸŒ˜
crescent	ğŸŒ˜
tent	â›ºï¸
fencer	ğŸ¥¡
regional indicator symbol letters st	ğŸ‡¸ğŸ‡¹
flag for argentina	ğŸ‡¦ğŸ‡·
regional indicator symbol letters ar	ğŸ‡¦ğŸ‡·
flag for french southern territories	ğŸ‡¹ğŸ‡«
regional indicator symbol letters tf	ğŸ‡¹ğŸ‡«
french southern lands flag	ğŸ‡¹ğŸ‡«
black raised hand with part between middle and ring fingers	ğŸ––ğŸ¿
lion	ğŸ¾
bear	ğŸ¾
footsteps	ğŸ¾
paw prints	ğŸ¾
critter	ğŸ¾
kitten paw prints	ğŸ¾
dog	ğŸ¾
feet	ğŸ¾
animal	ğŸ¾
dog paw prints	ğŸ¾
puppy paw prints	ğŸ¾
raccoon	ğŸ¾
imprints	ğŸ¾
paw	ğŸ¾
mark	ğŸ¾
cat	ğŸ¾
prints	ğŸ¾
cat paw prints	ğŸ¾
pawsteps	ğŸ¾
gridiron	ğŸˆ
superbowl	ğŸˆ
american football	ğŸˆ
sport	ğŸˆ
ball	ğŸˆ
football	ğŸˆ
american	ğŸˆ
america	ğŸˆ
keycap digit three	3ï¸âƒ£
olive toned face with no good gesture	ğŸ™…ğŸ½
white right pointing backhand index	ğŸ‘‰
pointing right	ğŸ‘‰
family of two men with one girl and one boy	ğŸ‘¨â€ğŸ‘¨â€ğŸ‘§â€ğŸ‘¦
lying face	ğŸ¤¥
pinocchio	ğŸ¤¥
long nose	ğŸ¤¥
liar	ğŸ¤¥
spiral calendar pad	ğŸ—“
clock face eight oclock	ğŸ•—
cross eyes face	ğŸ˜µ
drunk	ğŸ˜µ
inebriated	ğŸ˜µ
dizzy face	ğŸ˜µ
dizzy	ğŸ˜µ
spiral eyes face	ğŸ˜µ
mans shoe	ğŸ‘
shoe	ğŸ‘
brown shoe	ğŸ‘
flag for greece	ğŸ‡¬ğŸ‡·
regional indicator symbol letters gr	ğŸ‡¬ğŸ‡·
flag for pakistan	ğŸ‡µğŸ‡°
regional indicator symbol letters pk	ğŸ‡µğŸ‡°
pakistani flag	ğŸ‡µğŸ‡°
electric torch	ğŸ”¦
torch	ğŸ”¦
flashlight	ğŸ”¦
control knobs	ğŸ›
white man with turban	ğŸ‘³ğŸ»
fork and knife with plate	ğŸ½
slightly smiling face	ğŸ™‚
slightly happy	ğŸ™‚
flag for somalia	ğŸ‡¸ğŸ‡´
regional indicator symbol letters so	ğŸ‡¸ğŸ‡´
regional indicator symbol letters us	ğŸ‡ºğŸ‡¸
flag for united states	ğŸ‡ºğŸ‡¸
usa flag	ğŸ‡ºğŸ‡¸
american flag	ğŸ‡ºğŸ‡¸
light brown person bowing deeply	ğŸ™‡ğŸ¼
moon	ğŸ´
flower	ğŸ´
hanafuda	ğŸ´
playing cards	ğŸ´
deck of cards	ğŸ´
hwatu	ğŸ´
august	ğŸ´
playing	ğŸ´
special	ğŸ´
card	ğŸ´
game	ğŸ´
flower playing cards	ğŸ´
flag for turkmenistan	ğŸ‡¹ğŸ‡²
regional indicator symbol letters tm	ğŸ‡¹ğŸ‡²
snowman without snow	â›„
snowman	â›„
frosty the snowman	â›„
olaf	â›„
black thumbs up sign	ğŸ‘ğŸ¿
leftwards arrow with hook	â†©ï¸
mono	ğŸš
transport	ğŸš
monorail	ğŸš
train	ğŸš
rail	ğŸš
sakura	ğŸŒ¸
flower	ğŸŒ¸
blossom	ğŸŒ¸
cherry	ğŸŒ¸
tree	ğŸŒ¸
pink flower	ğŸŒ¸
cherry blossom	ğŸŒ¸
black white up pointing backhand index	ğŸ‘†ğŸ¿
deeper brown person with folded hands	ğŸ™ğŸ¾
lion face	ğŸ¦
cute lion	ğŸ¦
timid lion	ğŸ¦
olive toned guardsman	ğŸ’‚ğŸ½
litter	ğŸš¯
garbage	ğŸš¯
can	ğŸš¯
waste	ğŸš¯
no	ğŸš¯
do not litter symbol	ğŸš¯
trash	ğŸš¯
needle	ğŸ’‰
syringe	ğŸ’‰
vaccination	ğŸ’‰
blood donation	ğŸ’‰
blood test	ğŸ’‰
black raised fist	âœŠğŸ¿
baseball	âš¾
softball	âš¾
light brown ear	ğŸ‘‚ğŸ¼
family of a man and woman with two girls	ğŸ‘¨â€ğŸ‘©â€ğŸ‘§â€ğŸ‘§
light brown boy	ğŸ‘¦ğŸ¼
copyright sign	Â©ï¸
snake	ğŸ
green snake	ğŸ
black bride with veil	ğŸ‘°ğŸ¿
flag for brunei	ğŸ‡§ğŸ‡³
regional indicator symbol letters bn	ğŸ‡§ğŸ‡³
bruneian flag	ğŸ‡§ğŸ‡³
â„¹ lowercase i	â„¹ï¸
â„¹ info	â„¹ï¸
â„¹ tourist information	â„¹ï¸
â„¹ help icon	â„¹ï¸
information source	â„¹ï¸
light brown older man	ğŸ‘´ğŸ¼
wine glass	ğŸ·
fermented	ğŸ·
red wine	ğŸ·
tasting	ğŸ·
wine	ğŸ·
grapes	ğŸ·
alcohol	ğŸ·
glass	ğŸ·
winery	ğŸ·
bottle	ğŸ·
wc	ğŸš¾
porcelain	ğŸš¾
bathroom	ğŸš¾
throne	ğŸš¾
water closet	ğŸš¾
toilet	ğŸš¾
water	ğŸš¾
toilet wc	ğŸš¾
plumbing	ğŸš¾
flush	ğŸš¾
waste	ğŸš¾
closet	ğŸš¾
star of david	âœ¡
books	ğŸ“š
pile of books	ğŸ“š
stack of books	ğŸ“š
blushing face	ğŸ˜³
cheeks	ğŸ˜³
flushed face	ğŸ˜³
shame	ğŸ˜³
flush	ğŸ˜³
blush	ğŸ˜³
pink	ğŸ˜³
embarrassed	ğŸ˜³
red	ğŸ˜³
sneezing face	ğŸ¤§
black fisted hand sign	ğŸ‘ŠğŸ¿
black nib	âœ’ï¸
greek	â™ˆï¸
stars	â™ˆï¸
ram	â™ˆï¸
sign	â™ˆï¸
aries	â™ˆï¸
astrology	â™ˆï¸
constellation	â™ˆï¸
zodiac	â™ˆï¸
seat	ğŸ’º
bed	ğŸ›
bedroom	ğŸ›
world map	ğŸ—º
playing card black joker	ğŸƒ
joker	ğŸƒ
joker card	ğŸƒ
money bag	ğŸ’°
moneybags	ğŸ’°
rich	ğŸ’°
umbrella with rain drops	â˜”ï¸
black older woman	ğŸ‘µğŸ¿
ice hockey stick and puck	ğŸ’
ice hockey	ğŸ’
flag for iran	ğŸ‡®ğŸ‡·
regional indicator symbol letters ir	ğŸ‡®ğŸ‡·
flag for monaco	ğŸ‡²ğŸ‡¨
planet	ğŸŒ
world	ğŸŒ
home	ğŸŒ
north	ğŸŒ
globe	ğŸŒ
space	ğŸŒ
south	ğŸŒ
earth globe americas	ğŸŒ
americas	ğŸŒ
america	ğŸŒ
earth	ğŸŒ
left fist bump	ğŸ¤›
tent	â›º
camping tent	â›º
light brown waving hand sign	ğŸ‘‹ğŸ¼
reversed hand with middle finger extended	ğŸ–•
flipping the bird	ğŸ–•
middle finger	ğŸ–•
dito medio	ğŸ–•
rude finger	ğŸ–•
double exclamation mark	â€¼ï¸
light brown clapping hands sign	ğŸ‘ğŸ¼
cheers	ğŸ»
clinking beer mugs	ğŸ»
jolly	ğŸ»
pub	ğŸ»
beers	ğŸ»
beer	ğŸ»
clink	ğŸ»
mug	ğŸ»
bar	ğŸ»
hops	ğŸ»
celebrate	ğŸ»
toast	ğŸ»
flag for ascension island	ğŸ‡¦ğŸ‡¨
olive toned baby angel	ğŸ‘¼ğŸ½
olive toned woman	ğŸ‘©ğŸ½
label	ğŸ·
flag for philippines	ğŸ‡µğŸ‡­
regional indicator symbol letters ph	ğŸ‡µğŸ‡­
television	ğŸ“º
tv	ğŸ“º
left triangle	â—€ï¸
compete	ğŸ½
running	ğŸ½
running shirt with sash	ğŸ½
run	ğŸ½
sports	ğŸ½
singlet	ğŸ½
cloths	ğŸ½
shirt	ğŸ½
running shirt	ğŸ½
family of two men with two boys	ğŸ‘¨â€ğŸ‘¨â€ğŸ‘¦â€ğŸ‘¦
cheese	ğŸŒ‘
moon	ğŸŒ‘
dark moon	ğŸŒ‘
phase	ğŸŒ‘
sky	ğŸŒ‘
night	ğŸŒ‘
solar eclipse	ğŸŒ‘
new	ğŸŒ‘
new moon symbol	ğŸŒ‘
shadow moon	ğŸŒ‘
wheelchair symbol	â™¿
accessible bathroom	â™¿
curry	ğŸ›
food	ğŸ›
spice	ğŸ›
indian food	ğŸ›
flavor	ğŸ›
meal	ğŸ›
curry and rice	ğŸ›
building construction	ğŸ—
keyboard	âŒ¨
flag for czech republic	ğŸ‡¨ğŸ‡¿
regional indicator symbol letters cz	ğŸ‡¨ğŸ‡¿
flag for nicaragua	ğŸ‡³ğŸ‡®
regional indicator symbol letters ni	ğŸ‡³ğŸ‡®
black rightwards arrow	â¡ï¸
playstation	ğŸ®
nintendo	ğŸ®
xbox	ğŸ®
wii u	ğŸ®
video	ğŸ®
console controller	ğŸ®
controller	ğŸ®
video game	ğŸ®
game	ğŸ®
console	ğŸ®
warning sign	âš ï¸
olive toned ok hand sign	ğŸ‘ŒğŸ½
greek	â™‰
stars	â™‰
taurus	â™‰
sign	â™‰
astrology	â™‰
constellation	â™‰
zodiac	â™‰
bull	â™‰
video camera	ğŸ“¹
camcorder	ğŸ“¹
flag for sint maarten	ğŸ‡¸ğŸ‡½
regional indicator symbol letters sx	ğŸ‡¸ğŸ‡½
shinto shrine	â›©
flag for guernsey	ğŸ‡¬ğŸ‡¬
olive toned open hands sign	ğŸ‘ğŸ½
traffic light	ğŸš¥
horizontal	ğŸš¥
yield	ğŸš¥
horizontal traffic light	ğŸš¥
stop	ğŸš¥
go	ğŸš¥
traffic	ğŸš¥
light	ğŸš¥
olive toned father christmas	ğŸ…ğŸ½
æº€	ğŸˆµ
full	ğŸˆµ
confounded face	ğŸ˜–
quivering mouth	ğŸ˜–
scrunched face	ğŸ˜–
confound	ğŸ˜–
puzzle	ğŸ˜–
perplex	ğŸ˜–
amaze	ğŸ˜–
mystify	ğŸ˜–
black person with blond hair	ğŸ‘±ğŸ¿
squared id	ğŸ†”
id	ğŸ†”
identification	ğŸ†”
detective	ğŸ•µ
spy	ğŸ•µ
sleuth or spy	ğŸ•µ
private eye	ğŸ•µ
sleuth	ğŸ•µ
baguette bread	ğŸ¥–
white medium small square	â—½ï¸
happy tears cat	ğŸ˜¹
tears	ğŸ˜¹
joy	ğŸ˜¹
laughing cat	ğŸ˜¹
happy	ğŸ˜¹
cat face with tears of joy	ğŸ˜¹
cry	ğŸ˜¹
cutlery	ğŸ´
fork and knife	ğŸ´
eat	ğŸ´
restaurant	ğŸ´
knife and fork	ğŸ´
fork	ğŸ´
food	ğŸ´
knife	ğŸ´
meal	ğŸ´
peace symbol	â˜®
peace sign	â˜®
flag for colombia	ğŸ‡¨ğŸ‡´
regional indicator symbol letters co	ğŸ‡¨ğŸ‡´
white sun with small cloud	ğŸŒ¤
speaker	ğŸ”ˆ
volume	ğŸ”ˆ
black man with turban	ğŸ‘³ğŸ¿
flag for slovakia	ğŸ‡¸ğŸ‡°
regional indicator symbol letters sk	ğŸ‡¸ğŸ‡°
sheep	ğŸ‘
female	ğŸ‘
ewe	ğŸ‘
wool	ğŸ‘
follower	ğŸ‘
flock	ğŸ‘
lamb	ğŸ‘
clown face	ğŸ¤¡
scary clown	ğŸ¤¡
flag for new zealand	ğŸ‡³ğŸ‡¿
regional indicator symbol letters nz	ğŸ‡³ğŸ‡¿
kiwi flag	ğŸ‡³ğŸ‡¿
frown	ğŸ˜¾
pouting cat face	ğŸ˜¾
miffed	ğŸ˜¾
glower	ğŸ˜¾
pout	ğŸ˜¾
annoyed	ğŸ˜¾
grumpy cat	ğŸ˜¾
avatar	ğŸš¹
mens symbol	ğŸš¹
bathroom	ğŸš¹
men	ğŸš¹
sign	ğŸš¹
male	ğŸš¹
boy	ğŸš¹
mens toilet	ğŸš¹
male restroom	ğŸš¹
restroom	ğŸš¹
no good	ğŸ†–
ng	ğŸ†–
blooper	ğŸ†–
squared ng	ğŸ†–
spider	ğŸ•·
shallow pan of food	ğŸ¥˜
cow	ğŸ”
cheeseburger	ğŸ”
meat	ğŸ”
burger	ğŸ”
beef	ğŸ”
hamburger	ğŸ”
deeper brown surfer	ğŸ„ğŸ¾
flag for marshall islands	ğŸ‡²ğŸ‡­
marshallese flag	ğŸ‡²ğŸ‡­
flag for laos	ğŸ‡±ğŸ‡¦
regional indicator symbol letters la	ğŸ‡±ğŸ‡¦
light brown mountain bicyclist	ğŸšµğŸ¼
motor boat	ğŸ›¥
rural	ğŸŒ„
sun	ğŸŒ„
sky	ğŸŒ„
color	ğŸŒ„
sunrise	ğŸŒ„
sunrise over mountains	ğŸŒ„
mountain	ğŸŒ„
morning	ğŸŒ„
regional indicator symbol letter p	ğŸ‡µ
black information desk person	ğŸ’ğŸ¿
car	ğŸš™
motorhome	ğŸš™
automobile	ğŸš™
recreational vehicle	ğŸš™
wagon	ğŸš™
rv	ğŸš™
campervan	ğŸš™
suv	ğŸš™
door	ğŸšª
front door	ğŸšª
entry	ğŸšª
enter	ğŸšª
doorway	ğŸšª
entrance	ğŸšª
exit	ğŸšª
olive toned nail polish	ğŸ’…ğŸ½
clock face eleven oclock	ğŸ•š
fox face	ğŸ¦Š
fox	ğŸ¦Š
raised fist	âœŠ
fist pump	âœŠ
heavy exclamation mark symbol	â—
ring	ğŸ’
engagement ring	ğŸ’
diamond ring	ğŸ’
diesel train	ğŸš†
regular train	ğŸš†
passenger train	ğŸš†
locomotive	ğŸš†
electric train	ğŸš†
train	ğŸš†
rail	ğŸš†
flag for ireland	ğŸ‡®ğŸ‡ª
regional indicator symbol letters ie	ğŸ‡®ğŸ‡ª
irish flag	ğŸ‡®ğŸ‡ª
flag for mauritania	ğŸ‡²ğŸ‡·
regional indicator symbol letters mr	ğŸ‡²ğŸ‡·
banana	ğŸ’
monkey	ğŸ’
primate	ğŸ’
silly	ğŸ’
cheeky monkey	ğŸ’
light brown horse racing	ğŸ‡ğŸ¼
please	ğŸ™
thank you	ğŸ™
regret	ğŸ™
hands	ğŸ™
sorrow	ğŸ™
person with folded hands	ğŸ™
praying hands	ğŸ™
sorry	ğŸ™
pray	ğŸ™
high five	ğŸ™
flag for uganda	ğŸ‡ºğŸ‡¬
regional indicator symbol letters ug	ğŸ‡ºğŸ‡¬
flag in hole	â›³
golf	â›³
golf flag	â›³
file folder	ğŸ“
flag for benin	ğŸ‡§ğŸ‡¯
regional indicator symbol letters bj	ğŸ‡§ğŸ‡¯
beninese flag	ğŸ‡§ğŸ‡¯
back with leftwards arrow above	ğŸ”™
back	ğŸ”™
white raised hand	âœ‹ğŸ»
squared up with exclamation mark	ğŸ†™
up	ğŸ†™
level up	ğŸ†™
man dancing	ğŸ•º
male dancer	ğŸ•º
disco dancer	ğŸ•º
flag for paraguay	ğŸ‡µğŸ‡¾
regional indicator symbol letters py	ğŸ‡µğŸ‡¾
shibuya	î”Š
boutique 109	î”Š
shibuya 109	î”Š
shibuya 109 department store	î”Š
plant	ğŸŒ±
sprout	ğŸŒ±
sprouting	ğŸŒ±
spring	ğŸŒ±
seedling	ğŸŒ±
grow	ğŸŒ±
new	ğŸŒ±
start	ğŸŒ±
silent	ğŸ˜¯
surprised face	ğŸ˜¯
quiet	ğŸ˜¯
surprise	ğŸ˜¯
hush	ğŸ˜¯
hushed face	ğŸ˜¯
whisper	ğŸ˜¯
flag for tristan da cunha	ğŸ‡¹ğŸ‡¦
ballot box with ballot	ğŸ—³
flag for spain	ğŸ‡ªğŸ‡¸
regional indicator symbol letters es	ğŸ‡ªğŸ‡¸
spanish flag	ğŸ‡ªğŸ‡¸
reminder ribbon	ğŸ—
white bride with veil	ğŸ‘°ğŸ»
black swimmer	ğŸŠğŸ¿
incoming envelope	ğŸ“¨
fast envelope	ğŸ“¨
envelope with lines	ğŸ“¨
flag for montenegro	ğŸ‡²ğŸ‡ª
regional indicator symbol letters me	ğŸ‡²ğŸ‡ª
hinamatsuri	ğŸ
dolls	ğŸ
girls	ğŸ
imperial	ğŸ
japanese dolls	ğŸ
japan	ğŸ
blessing	ğŸ
pray	ğŸ
imperial dolls	ğŸ
family	ğŸ
royal	ğŸ
empress	ğŸ
japanese	ğŸ
day	ğŸ
emperor	ğŸ
music	ğŸ»
string quartet	ğŸ»
violin	ğŸ»
instrument	ğŸ»
fiddle	ğŸ»
house with garden	ğŸ¡
house and tree	ğŸ¡
bunny rabbit	ğŸ°
bugs bunny	ğŸ°
easter bunny	ğŸ°
rabbit face	ğŸ°
no speaking	ğŸ™Š
verbal	ğŸ™Š
talk	ğŸ™Š
monkey	ğŸ™Š
verbalize	ğŸ™Š
monkey covering mouth	ğŸ™Š
oral	ğŸ™Š
words	ğŸ™Š
say	ğŸ™Š
iwazaru	ğŸ™Š
mouth	ğŸ™Š
red pin	ğŸ“
round pushpin	ğŸ“
map pin	ğŸ“
pin	ğŸ“
dropped pin	ğŸ“
cheese	ğŸŒ’
moon	ğŸŒ’
phase	ğŸŒ’
sky	ğŸŒ’
night	ğŸŒ’
waxing	ğŸŒ’
waxing crescent moon symbol	ğŸŒ’
passenger ship	ğŸ›³
racing car	ğŸ
f1	ğŸ
formula one	ğŸ
light bulb	ğŸ’¡
idea	ğŸ’¡
bulb	ğŸ’¡
electric light bulb	ğŸ’¡
light	ğŸ’¡
sailboat	â›µï¸
omkara	ğŸ•‰
pranava	ğŸ•‰
aumkara	ğŸ•‰
om symbol	ğŸ•‰
white heavy check mark	âœ…
tick	âœ…
check	âœ…
white heavy tick mark	âœ…
flag for maldives	ğŸ‡²ğŸ‡»
regional indicator symbol letters mv	ğŸ‡²ğŸ‡»
tortoise	ğŸ¢
slow	ğŸ¢
shell	ğŸ¢
turtle	ğŸ¢
chelonian	ğŸ¢
steady	ğŸ¢
reptile	ğŸ¢
snap	ğŸ¢
flag for romania	ğŸ‡·ğŸ‡´
regional indicator symbol letters ro	ğŸ‡·ğŸ‡´
flag for estonia	ğŸ‡ªğŸ‡ª
regional indicator symbol letters ee	ğŸ‡ªğŸ‡ª
estonian flag	ğŸ‡ªğŸ‡ª
frown	ğŸ‘º
mustache	ğŸ‘º
mask	ğŸ‘º
goblin	ğŸ‘º
nose	ğŸ‘º
tengu	ğŸ‘º
frustration	ğŸ‘º
japanese goblin	ğŸ‘º
demon	ğŸ‘º
supernatural	ğŸ‘º
red mask	ğŸ‘º
theater	ğŸ‘º
anger	ğŸ‘º
long nose face	ğŸ‘º
japanese	ğŸ‘º
avian	ğŸ‘º
white surfer	ğŸ„ğŸ»
black spade suit	â™ ï¸
spades	â™ ï¸
fair	ğŸ¡
farris	ğŸ¡
amusement	ğŸ¡
wheel	ğŸ¡
big wheel	ğŸ¡
entertainment	ğŸ¡
fairground	ğŸ¡
park	ğŸ¡
ferris wheel	ğŸ¡
ride	ğŸ¡
observation wheel	ğŸ¡
deeper brown dancer	ğŸ’ƒğŸ¾
flag for aruba	ğŸ‡¦ğŸ‡¼
regional indicator symbol letters aw	ğŸ‡¦ğŸ‡¼
åˆ	ğŸˆ´
agreement	ğŸˆ´
daze	ğŸ˜•
puzzled	ğŸ˜•
puzzle	ğŸ˜•
confused face	ğŸ˜•
confuse	ğŸ˜•
perplex	ğŸ˜•
nonplussed	ğŸ˜•
confused	ğŸ˜•
stairs	ğŸ“¶
reception bars	ğŸ“¶
signal strength	ğŸ“¶
antenna with bars	ğŸ“¶
fruit	ğŸ’
cherries	ğŸ’
cherry	ğŸ’
wild cherry	ğŸ’
tree	ğŸ’
pit	ğŸ’
poultry	ğŸ”
hen	ğŸ”
chicken	ğŸ”
livestock	ğŸ”
turkey	ğŸ”
flag for sweden	ğŸ‡¸ğŸ‡ª
regional indicator symbol letters se	ğŸ‡¸ğŸ‡ª
æœˆ	ğŸˆ·ï¸
radical 74	ğŸˆ·ï¸
open mailbox with lowered flag	ğŸ“­
white boy	ğŸ‘¦ğŸ»
white haircut	ğŸ’‡ğŸ»
checkered	ğŸ
chequred	ğŸ
finish	ğŸ
complete	ğŸ
racing flag	ğŸ
race	ğŸ
flag	ğŸ
end	ğŸ
grid girl	ğŸ
checkered flag	ğŸ
chequered flag	ğŸ
sun	ğŸŒ…
sky	ğŸŒ…
color	ğŸŒ…
sunrise	ğŸŒ…
sunset	ğŸŒ…
morning	ğŸŒ…
lips sealed	ğŸ¤
zip it	ğŸ¤
sealed lips	ğŸ¤
six pointed star with middle dot	ğŸ”¯
unamused	ğŸ˜’
unamused face	ğŸ˜’
lame	ğŸ˜’
depressed	ğŸ˜’
not amused	ğŸ˜’
unhappy	ğŸ˜’
unimpressed	ğŸ˜’
disapprove	ğŸ˜’
dissatisfied	ğŸ˜’
white woman	ğŸ‘©ğŸ»
flag for cape verde	ğŸ‡¨ğŸ‡»
regional indicator symbol letters cv	ğŸ‡¨ğŸ‡»
classical building	ğŸ›
honey	ğŸ¯
bear	ğŸ¯
pot	ğŸ¯
bees	ğŸ¯
honey pot	ğŸ¯
pooh	ğŸ¯
pregnant woman	ğŸ¤°
pregnant lady	ğŸ¤°
pregnancy	ğŸ¤°
flag for albania	ğŸ‡¦ğŸ‡±
regional indicator symbol letters al	ğŸ‡¦ğŸ‡±
gamble	ğŸ²
play	ğŸ²
die	ğŸ²
craps	ğŸ²
game die	ğŸ²
game	ğŸ²
dice	ğŸ²
kissing cat face with closed eyes	ğŸ˜½
kissing cat	ğŸ˜½
love	ğŸ˜½
puckered	ğŸ˜½
passion	ğŸ˜½
heart	ğŸ˜½
kiss	ğŸ˜½
flag for burkina faso	ğŸ‡§ğŸ‡«
regional indicator symbol letters bf	ğŸ‡§ğŸ‡«
flag for sierra leone	ğŸ‡¸ğŸ‡±
regional indicator symbol letters sl	ğŸ‡¸ğŸ‡±
serve	ğŸ¨
dessert	ğŸ¨
bowl of ice cream	ğŸ¨
soft	ğŸ¨
icecream	ğŸ¨
waffle	ğŸ¨
dairy	ğŸ¨
cone	ğŸ¨
cold	ğŸ¨
cream	ğŸ¨
ice	ğŸ¨
ice cream	ğŸ¨
question	ğŸ’
sassy	ğŸ’
snarky	ğŸ’
information desk person	ğŸ’
information	ğŸ’
attitude	ğŸ’
concierge	ğŸ’
help	ğŸ’
sassy girl	ğŸ’
answer	ğŸ’
hair flick	ğŸ’
bellhop	ğŸ’
unimpressed	ğŸ’
eagle	ğŸ¦…
bald eagle	ğŸ¦…
black heart	ğŸ–¤
dark heart	ğŸ–¤
pencil	âœï¸
triangular ruler	ğŸ“
triangle ruler	ğŸ“
olive toned person with pouting face	ğŸ™ğŸ½
black sun with rays	â˜€ï¸
sun	â˜€ï¸
sunshine	â˜€ï¸
maiden	â™
greek	â™
stars	â™
virgo	â™
sign	â™
astrology	â™
constellation	â™
zodiac	â™
golden delicious apple	ğŸ
green apple	ğŸ
fruit	ğŸ
granny	ğŸ
pie	ğŸ
green	ğŸ
grevenstein apple	ğŸ
apple	ğŸ
smith	ğŸ
core	ğŸ
granny smith apple	ğŸ
officer	ğŸš”
police	ğŸš”
car	ğŸš”
ticket	ğŸš”
citation	ğŸš”
help	ğŸš”
crime	ğŸš”
emergency	ğŸš”
oncoming police car	ğŸš”
butterflies in stomach	ğŸ’“
beating heart	ğŸ’“
heart alarm	ğŸ’“
heartbeat	ğŸ’“
white person with blond hair	ğŸ‘±ğŸ»
waving black flag	ğŸ´
olive toned happy person raising one hand	ğŸ™‹ğŸ½
shoot	ğŸŒ 
shooting	ğŸŒ 
when you wish upon a star	ğŸŒ 
sky	ğŸŒ 
night	ğŸŒ 
star	ğŸŒ 
comet	ğŸŒ 
shooting star	ğŸŒ 
meteoroid	ğŸŒ 
spock	ğŸ––
raised hand with part between middle and ring fingers	ğŸ––
star trek	ğŸ––
vulcan salute	ğŸ––
light brown nail polish	ğŸ’…ğŸ¼
flag for zimbabwe	ğŸ‡¿ğŸ‡¼
regional indicator symbol letters zw	ğŸ‡¿ğŸ‡¼
flag for norfolk island	ğŸ‡³ğŸ‡«
norfolk island flag	ğŸ‡³ğŸ‡«
love heart	â¤ï¸
red heart	â¤ï¸
death	â¤ï¸
intense	â¤ï¸
heavy black heart	â¤ï¸
cold	â¤ï¸
black	â¤ï¸
love	â¤ï¸
pink	â¤ï¸
romance	â¤ï¸
passion	â¤ï¸
heart	â¤ï¸
evil	â¤ï¸
desire	â¤ï¸
red	â¤ï¸
squared cool	ğŸ†’
cool square	ğŸ†’
potato	ğŸ¥”
baked potato	ğŸ¥”
regular potato	ğŸ¥”
hole	ğŸ•³
deeper brown man with gua pi mao	ğŸ‘²ğŸ¾
scrunched eyes	ğŸ˜£
persevering face	ğŸ˜£
helpless face	ğŸ˜£
persevere	ğŸ˜£
endure	ğŸ˜£
shinkansen	ğŸš…
bullet	ğŸš…
train	ğŸš…
bullet train	ğŸš…
rail	ğŸš…
greek	â™ˆ
stars	â™ˆ
ram	â™ˆ
sign	â™ˆ
aries	â™ˆ
astrology	â™ˆ
constellation	â™ˆ
zodiac	â™ˆ
muslim	ğŸ‘³
man with turban	ğŸ‘³
india	ğŸ‘³
turban	ğŸ‘³
wisdom	ğŸ‘³
mummy	ğŸ‘³
headwear	ğŸ‘³
peace	ğŸ‘³
sikh	ğŸ‘³
indian	ğŸ‘³
pagri	ğŸ‘³
headdress	ğŸ‘³
arab	ğŸ‘³
pot of food	ğŸ²
hearty	ğŸ²
pot	ğŸ²
stew	ğŸ²
soup	ğŸ²
thick	ğŸ²
bowl of food	ğŸ²
hot	ğŸ²
snow capped mountain	ğŸ”
smiling face with open mouth and smiling eyes	ğŸ˜„
happy face	ğŸ˜„
smile	ğŸ˜„
smiley face	ğŸ˜„
smiling	ğŸ˜„
smiley	ğŸ˜„
grinning face	ğŸ˜„
black bicyclist	ğŸš´ğŸ¿
deeper brown ok hand sign	ğŸ‘ŒğŸ¾
exhausted	ğŸ˜ª
tired	ğŸ˜ª
sleepy face	ğŸ˜ª
sleepy	ğŸ˜ª
snot bubble	ğŸ˜ª
flag for moldova	ğŸ‡²ğŸ‡©
regional indicator symbol letters md	ğŸ‡²ğŸ‡©
white flexed biceps	ğŸ’ªğŸ»
nut and bolt	ğŸ”©
screw	ğŸ”©
bolt	ğŸ”©
eye	ğŸ‘
single eye	ğŸ‘
traffic light	ğŸš¦
yield	ğŸš¦
stop	ğŸš¦
vertical traffic light	ğŸš¦
vertical	ğŸš¦
go	ğŸš¦
traffic	ğŸš¦
light	ğŸš¦
olive toned white up pointing backhand index	ğŸ‘†ğŸ½
white information desk person	ğŸ’ğŸ»
bouquet	ğŸ’
bouquet of flowers	ğŸ’
black person raising both hands in celebration	ğŸ™ŒğŸ¿
flag for ghana	ğŸ‡¬ğŸ‡­
regional indicator symbol letters gh	ğŸ‡¬ğŸ‡­
ghanaian flag	ğŸ‡¬ğŸ‡­
tram	ğŸšŠ
transportation	ğŸšŠ
transport	ğŸšŠ
flag for qatar	ğŸ‡¶ğŸ‡¦
regional indicator symbol letters qa	ğŸ‡¶ğŸ‡¦
dress	ğŸ‘°
engagement	ğŸ‘°
veil	ğŸ‘°
marriage	ğŸ‘°
planning	ğŸ‘°
gown	ğŸ‘°
bride	ğŸ‘°
wedding	ğŸ‘°
bride with veil	ğŸ‘°
white	ğŸ‘°
search icon	ğŸ”
magnifying glass	ğŸ”
detective	ğŸ”
magnifier	ğŸ”
investigator	ğŸ”
details	ğŸ”
detail	ğŸ”
deeper brown man with turban	ğŸ‘³ğŸ¾
filly	ğŸ
stallion	ğŸ
horse racing	ğŸ
calvary	ğŸ
mare	ğŸ
galloping horse	ğŸ
draft	ğŸ
gallop	ğŸ
cowgirl	ğŸ
mounted	ğŸ
horse	ğŸ
powerful	ğŸ
thoroughbred	ğŸ
yearling	ğŸ
race	ğŸ
gelding	ğŸ
trot	ğŸ
colt	ğŸ
ride	ğŸ
pony	ğŸ
cowboy	ğŸ
year of the horse	ğŸ
light brown thumbs up sign	ğŸ‘ğŸ¼
white medium small square	â—½
squared new	ğŸ†•
new	ğŸ†•
green salad	ğŸ¥—
dark sunglasses	ğŸ•¶
black face massage	ğŸ’†ğŸ¿
flag for martinique	ğŸ‡²ğŸ‡¶
martiniquais flag	ğŸ‡²ğŸ‡¶
regional indicator symbol letters mq	ğŸ‡²ğŸ‡¶
snake flag of martinique	ğŸ‡²ğŸ‡¶
izakaya lantern	ğŸ®
sake	ğŸ®
restaurant	ğŸ®
drink	ğŸ®
lantern	ğŸ®
red lantern	ğŸ®
izakaya	ğŸ®
japanese lantern	ğŸ®
bar	ğŸ®
stay	ğŸ®
alcohol	ğŸ®
asian lantern	ğŸ®
four	ğŸ€
four leaf clover	ğŸ€
clover	ğŸ€
lucky	ğŸ€
luck	ğŸ€
ireland	ğŸ€
patrick	ğŸ€
green	ğŸ€
saint	ğŸ€
leaf	ğŸ€
irish	ğŸ€
dog face	ğŸ¶
dog	ğŸ¶
puppy	ğŸ¶
white sun behind cloud	ğŸŒ¥
black mountain bicyclist	ğŸšµğŸ¿
ox	ğŸ‚
oxen	ğŸ‚
bullock	ğŸ‚
greek	â™‹ï¸
stars	â™‹ï¸
crab	â™‹ï¸
sign	â™‹ï¸
cancer	â™‹ï¸
astrology	â™‹ï¸
constellation	â™‹ï¸
zodiac	â™‹ï¸
light brown older woman	ğŸ‘µğŸ¼
black thumbs down sign	ğŸ‘ğŸ¿
music	ğŸ·
saxophone	ğŸ·
sax	ğŸ·
jazz	ğŸ·
woodwind	ğŸ·
instrument	ğŸ·
white person bowing deeply	ğŸ™‡ğŸ»
right anger bubble	ğŸ—¯
zig zag bubble	ğŸ—¯
school	ğŸ’
sightsee	ğŸ’
bag	ğŸ’
packing	ğŸ’
school bag	ğŸ’
pack	ğŸ’
backpack	ğŸ’
travel	ğŸ’
education	ğŸ’
hike	ğŸ’
satchel	ğŸ’
school satchel	ğŸ’
adventure	ğŸ’
desert island	ğŸ
thought	ğŸ’­
thought bubble	ğŸ’­
comic	ğŸ’­
day dream	ğŸ’­
think	ğŸ’­
wonder	ğŸ’­
thinking bubble	ğŸ’­
balloon	ğŸ’­
thought balloon	ğŸ’­
dango	ğŸ¡
skewer	ğŸ¡
dumpling	ğŸ¡
dessert stick	ğŸ¡
pink white green balls	ğŸ¡
balls	ğŸ¡
japanese	ğŸ¡
mochi	ğŸ¡
satellite antenna	ğŸ“¡
flag for luxembourg	ğŸ‡±ğŸ‡º
regional indicator symbol letters lu	ğŸ‡±ğŸ‡º
skinny	ğŸ‘–
levi	ğŸ‘–
designer	ğŸ‘–
denim	ğŸ‘–
trousers	ğŸ‘–
blue	ğŸ‘–
jeans	ğŸ‘–
work	ğŸ‘–
pants	ğŸ‘–
mountain railway	ğŸš
funicular	ğŸš
railway	ğŸš
train and mountain	ğŸš
transport	ğŸš
train	ğŸš
mountain	ğŸš
rail	ğŸš
clingy	ğŸ’š
jealous heart	ğŸ’š
green heart	ğŸ’š
green	ğŸ’š
reborn	ğŸ’š
envious	ğŸ’š
love	ğŸ’š
possessive	ğŸ’š
nature	ğŸ’š
heart	ğŸ’š
rebirth	ğŸ’š
jealous	ğŸ’š
black face with ok gesture	ğŸ™†ğŸ¿
face palm	ğŸ¤¦
facepalm	ğŸ¤¦
hitting head	ğŸ¤¦
smh	ğŸ¤¦
bookmark	ğŸ”–
tag	ğŸ”–
price tag	ğŸ”–
flag for kyrgyzstan	ğŸ‡°ğŸ‡¬
regional indicator symbol letters kg	ğŸ‡°ğŸ‡¬
shield	ğŸ›¡
spiral	ğŸŒ€
storm	ğŸŒ€
ocean	ğŸŒ€
tornado	ğŸŒ€
swirl	ğŸŒ€
cyclone	ğŸŒ€
weather	ğŸŒ€
hurricane	ğŸŒ€
typhoon	ğŸŒ€
family of two women with one girl and one boy	ğŸ‘©â€ğŸ‘©â€ğŸ‘§â€ğŸ‘¦
flag for bermuda	ğŸ‡§ğŸ‡²
regional indicator symbol letters bm	ğŸ‡§ğŸ‡²
bermudan flag	ğŸ‡§ğŸ‡²
bovine	ğŸƒ
milk	ğŸƒ
water	ğŸƒ
dairy	ğŸƒ
water buffalo	ğŸƒ
domestic water buffalo	ğŸƒ
asia	ğŸƒ
buffalo	ğŸƒ
chart with downwards trend	ğŸ“‰
clockwise rightwards and leftwards open circle arrows	ğŸ”
loop symbol	ğŸ”
flag for namibia	ğŸ‡³ğŸ‡¦
regional indicator symbol letters na	ğŸ‡³ğŸ‡¦
spouting whale	ğŸ³
wink	ğŸ˜‰
winky face	ğŸ˜‰
wink face	ğŸ˜‰
friendly	ğŸ˜‰
joke	ğŸ˜‰
winking face	ğŸ˜‰
winking	ğŸ˜‰
light brown pedestrian	ğŸš¶ğŸ¼
black man	ğŸ‘¨ğŸ¿
white police officer	ğŸ‘®ğŸ»
newspaper	ğŸ“°
apple times	ğŸ“°
front page	ğŸ“°
news	ğŸ“°
keycap number sign	#ï¸âƒ£
yeast	ğŸ
loaf	ğŸ
loaf of bread	ğŸ
bread	ğŸ
input symbol for latin small letters	ğŸ”¡
abcd	ğŸ”¡
lowercase	ğŸ”¡
city	ğŸš
bus	ğŸš
pepsi	ğŸš
transportation	ğŸš
stop	ğŸš
transport	ğŸš
bus stop	ğŸš
snoring	ğŸ˜´
sleep	ğŸ˜´
snore	ğŸ˜´
sleep face	ğŸ˜´
sleeping	ğŸ˜´
zzz face	ğŸ˜´
sleeping face	ğŸ˜´
sleepy	ğŸ˜´
file cabinet	ğŸ—„
greek	â™“
stars	â™“
sign	â™“
astrology	â™“
pisces	â™“
fish	â™“
constellation	â™“
zodiac	â™“
light brown swimmer	ğŸŠğŸ¼
no deal	ğŸ™…
stop	ğŸ™…
nope	ğŸ™…
x arms	ğŸ™…
face with no good gesture	ğŸ™…
not	ğŸ™…
no	ğŸ™…
white square button	ğŸ”³
thinking face	ğŸ¤”
thinker	ğŸ¤”
regional indicator symbol letter i	ğŸ‡®
baby	ğŸ‘¶
toddler	ğŸ‘¶
child	ğŸ‘¶
olive toned clapping hands sign	ğŸ‘ğŸ½
flag for western sahara	ğŸ‡ªğŸ‡­
olive toned rowboat	ğŸš£ğŸ½
porcelain	ğŸš½
bathroom	ğŸš½
throne	ğŸš½
toilet	ğŸš½
loo	ğŸš½
plumbing	ğŸš½
flush	ğŸš½
waste	ğŸš½
restroom	ğŸš½
open hands sign	ğŸ‘
hug	ğŸ‘
jazz hands	ğŸ‘
gate	ğŸŒ‰
bridge at night	ğŸŒ‰
night	ğŸŒ‰
bridge	ğŸŒ‰
golden gate bridge	ğŸŒ‰
water	ğŸŒ‰
road	ğŸŒ‰
evening	ğŸŒ‰
suspension	ğŸŒ‰
golden	ğŸŒ‰
rockmelon	ğŸˆ
honeydew	ğŸˆ
cantaloupe	ğŸˆ
cantaloupe emoiji	ğŸˆ
melon	ğŸˆ
flag for israel	ğŸ‡®ğŸ‡±
regional indicator symbol letters il	ğŸ‡®ğŸ‡±
israeli flag	ğŸ‡®ğŸ‡±
white large square	â¬œ
deeper brown white right pointing backhand index	ğŸ‘‰ğŸ¾
anchor	âš“
shipyard	âš“
harbor	âš“
tattoo	âš“
boat	âš“
marina	âš“
admiralty pattern anchor	âš“
fisherman	âš“
ocean	âš“
ship	âš“
sailor	âš“
olive toned girl	ğŸ‘§ğŸ½
olive toned nose	ğŸ‘ƒğŸ½
conceited	ğŸ˜
smirking face	ğŸ˜
smug face	ğŸ˜
suggestive smile	ğŸ˜
smirk	ğŸ˜
smile	ğŸ˜
flirting	ğŸ˜
smug	ğŸ˜
smirking	ğŸ˜
sexual face	ğŸ˜
regional indicator symbol letters do	ğŸ‡©ğŸ‡´
dominican flag	ğŸ‡©ğŸ‡´
flag for dominican republic	ğŸ‡©ğŸ‡´
dom rep flag	ğŸ‡©ğŸ‡´
light brown raised hand	âœ‹ğŸ¼
birthday	ğŸ
package	ğŸ
christmas present	ğŸ
gift box	ğŸ
present	ğŸ
gift	ğŸ
birthday present	ğŸ
wrap	ğŸ
wrapped present	ğŸ
wedding	ğŸ
blurry	ğŸ‘“
eye	ğŸ‘“
sight	ğŸ‘“
eyeglasses	ğŸ‘“
frames	ğŸ‘“
contacts	ğŸ‘“
spectacles	ğŸ‘“
vision	ğŸ‘“
nearsightedness	ğŸ‘“
hyperopia	ğŸ‘“
farsightedness	ğŸ‘“
glasses	ğŸ‘“
see	ğŸ‘“
myopia	ğŸ‘“
flag for south sudan	ğŸ‡¸ğŸ‡¸
regional indicator symbol letters ss	ğŸ‡¸ğŸ‡¸
fire	ğŸ”¥
snapstreak	ğŸ”¥
flame	ğŸ”¥
hot	ğŸ”¥
hot beverage	â˜•
coffee	â˜•
tea	â˜•
hot chocolate	â˜•
keycap digit one	1âƒ£ï¸
octopus	ğŸ™
squid	ğŸ™
art	ğŸ¨
painting	ğŸ¨
paint	ğŸ¨
artist palette	ğŸ¨
oils	ğŸ¨
colors	ğŸ¨
draw	ğŸ¨
artist	ğŸ¨
pastels	ğŸ¨
brush	ğŸ¨
palette	ğŸ¨
fountain	â›²
water fountain	â›²
water feature	â›²
park	â›²
cheese	ğŸŒœ
last quarter moon with face	ğŸŒœ
moon	ğŸŒœ
phase	ğŸŒœ
sky	ğŸŒœ
night	ğŸŒœ
quarter	ğŸŒœ
last	ğŸŒœ
anthropomorphic	ğŸŒœ
face	ğŸŒœ
arrow pointing rightwards then curving downwards	â¤µï¸
prince	ğŸ¤´
clock face four oclock	ğŸ•“
thunder cloud and rain	â›ˆ
eject symbol	â
black baby	ğŸ‘¶ğŸ¿
children	ğŸ
carp streamer	ğŸ
flags	ğŸ
happiness	ğŸ
carp	ğŸ
streamers	ğŸ
celebration	ğŸ
holiday	ğŸ
kids	ğŸ
japanese	ğŸ
boys	ğŸ
olive toned construction worker	ğŸ‘·ğŸ½
wash	ğŸ›
bathroom	ğŸ›
shampoo	ğŸ›
clean	ğŸ›
bubble	ğŸ›
water	ğŸ›
tub	ğŸ›
empty bathtub	ğŸ›
soap	ğŸ›
soak	ğŸ›
bathtub	ğŸ›
lather	ğŸ›
basin	ğŸ›
bath	ğŸ›
birthday	ğŸˆ
children	ğŸˆ
float	ğŸˆ
red balloon	ğŸˆ
helium	ğŸˆ
gas	ğŸˆ
celebration	ğŸˆ
party	ğŸˆ
balloon	ğŸˆ
olive toned person frowning	ğŸ™ğŸ½
regional indicator symbol letters cg	ğŸ‡¨ğŸ‡¬
vapid	ğŸ˜¶
silent	ğŸ˜¶
face without mouth	ğŸ˜¶
blank face	ğŸ˜¶
silence	ğŸ˜¶
mouthless	ğŸ˜¶
mouth	ğŸ˜¶
flag for puerto rico	ğŸ‡µğŸ‡·
regional indicator symbol letters pr	ğŸ‡µğŸ‡·
flower	ğŸŒ¼
blossom	ğŸŒ¼
blossoming flower	ğŸŒ¼
yellow flower	ğŸŒ¼
daisy	ğŸŒ¼
flag for china	ğŸ‡¨ğŸ‡³
regional indicator symbol letters cn	ğŸ‡¨ğŸ‡³
chinese flag	ğŸ‡¨ğŸ‡³
black flexed biceps	ğŸ’ªğŸ¿
flag for brazil	ğŸ‡§ğŸ‡·
regional indicator symbol letters br	ğŸ‡§ğŸ‡·
no bikes sign	ğŸš³
bicycle	ğŸš³
bike pedal	ğŸš³
no bicycles	ğŸš³
no	ğŸš³
womans sandal	ğŸ‘¡
sandals	ğŸ‘¡
white fisted hand sign	ğŸ‘ŠğŸ»
light brown person frowning	ğŸ™ğŸ¼
open book	ğŸ“–
book	ğŸ“–
novel	ğŸ“–
closed lock with key	ğŸ”
lock and key	ğŸ”
bow	ğŸ™‡
dogeza	ğŸ™‡
person bowing deeply	ğŸ™‡
massage	ğŸ™‡
bend	ğŸ™‡
cute boy	ğŸ™‡
curtsy	ğŸ™‡
sorry	ğŸ™‡
respect	ğŸ™‡
bowing man	ğŸ™‡
white raised fist	âœŠğŸ»
border control	ğŸ›‚
identification	ğŸ›‚
passport control	ğŸ›‚
passport	ğŸ›‚
travel	ğŸ›‚
official	ğŸ›‚
foreign	ğŸ›‚
control	ğŸ›‚
sparkling wine	ğŸ¾
celebration	ğŸ¾
champagne	ğŸ¾
bottle with popping cork	ğŸ¾
yellow dog	ğŸº
wolf face	ğŸº
dingo	ğŸº
fox	ğŸº
flag for myanmar	ğŸ‡²ğŸ‡²
regional indicator symbol letters mm	ğŸ‡²ğŸ‡²
flag for zambia	ğŸ‡¿ğŸ‡²
regional indicator symbol letters zm	ğŸ‡¿ğŸ‡²
bills	ğŸ’¶
banknote	ğŸ’¶
euro	ğŸ’¶
banknote with euro sign	ğŸ’¶
paper	ğŸ’¶
money	ğŸ’¶
currency	ğŸ’¶
europe	ğŸ’¶
cash	ğŸ’¶
domestic cat	ğŸˆ
kitten	ğŸˆ
housecat	ğŸˆ
feline	ğŸˆ
cat	ğŸˆ
meow	ğŸˆ
regional indicator symbol letter o	ğŸ‡´
flag for mozambique	ğŸ‡²ğŸ‡¿
regional indicator symbol letters mz	ğŸ‡²ğŸ‡¿
cloud with lightning	ğŸŒ©
anguished face	ğŸ˜§
misery	ğŸ˜§
pained face	ğŸ˜§
grief	ğŸ˜§
anguish	ğŸ˜§
ouch	ğŸ˜§
pain	ğŸ˜§
distress	ğŸ˜§
negative squared ab	ğŸ†
blood type ab	ğŸ†
croissant	ğŸ¥
candle	ğŸ•¯
family of a man and woman with one girl	ğŸ‘¨â€ğŸ‘©â€ğŸ‘§
flag for libya	ğŸ‡±ğŸ‡¾
regional indicator symbol letters ly	ğŸ‡±ğŸ‡¾
pink shirt	ğŸ‘š
shop	ğŸ‘š
breasts	ğŸ‘š
womans clothes	ğŸ‘š
woman	ğŸ‘š
blouse	ğŸ‘š
shopping	ğŸ‘š
clothes	ğŸ‘š
clothing	ğŸ‘š
dressed	ğŸ‘š
wardrobe	ğŸ‘š
cleavage	ğŸ‘š
shirt	ğŸ‘š
dressing	ğŸ‘š
pile of poo	ğŸ’©
pile	ğŸ’©
poo	ğŸ’©
smiling poop	ğŸ’©
crap	ğŸ’©
dung	ğŸ’©
poop	ğŸ’©
large orange diamond	ğŸ”¶
hugging	ğŸ¤—
hugs	ğŸ¤—
hug	ğŸ¤—
hugging face	ğŸ¤—
rich	ğŸ¤‘
dollar sign eyes	ğŸ¤‘
money face	ğŸ¤‘
japanese symbol for beginner	ğŸ”°
shield	ğŸ”°
shoshinsha mark	ğŸ”°
olive toned person with folded hands	ğŸ™ğŸ½
white horse racing	ğŸ‡ğŸ»
grinning cat	ğŸ˜¸
grinning	ğŸ˜¸
grin	ğŸ˜¸
smile	ğŸ˜¸
grinning cat face with smiling eyes	ğŸ˜¸
happy cat	ğŸ˜¸
cat	ğŸ˜¸
writing hand	âœ
wash	ğŸš¿
shower	ğŸš¿
bathroom	ğŸš¿
shampoo	ğŸš¿
clean	ğŸš¿
shower head	ğŸš¿
water	ğŸš¿
soap	ğŸš¿
lather	ğŸš¿
soccer ball	âš½
soccer	âš½
football	âš½
european	âš½
calendar	ğŸ“…
july 17	ğŸ“…
world emoji day	ğŸ“…
scorpion	ğŸ¦‚
negative squared cross mark	â
cross	â
x	â
face massage	ğŸ’†
massaging	ğŸ’†
head massage	ğŸ’†
light brown guardsman	ğŸ’‚ğŸ¼
inbox tray	ğŸ“¥
black medium square	â—¼ï¸
heart eyes	ğŸ˜
smile	ğŸ˜
flirt	ğŸ˜
heart face	ğŸ˜
love	ğŸ˜
smiling	ğŸ˜
lovestruck	ğŸ˜
heart	ğŸ˜
keycap digit seven	7ï¸âƒ£
sale	ğŸ¬
store	ğŸ¬
department	ğŸ¬
merchandise	ğŸ¬
shops	ğŸ¬
shopping center	ğŸ¬
department store	ğŸ¬
retail	ğŸ¬
heavy check mark	âœ”ï¸
pig face	ğŸ·
pig head	ğŸ·
regional indicator symbol letter z	ğŸ‡¿
sweet	ğŸ©
police	ğŸ©
dessert	ğŸ©
doughnut	ğŸ©
pastry	ğŸ©
donut	ğŸ©
fried	ğŸ©
breakfast	ğŸ©
homer	ğŸ©
regional indicator symbol letter g	ğŸ‡¬
plant	ğŸŒ¾
seed	ğŸŒ¾
rice	ğŸŒ¾
wheat	ğŸŒ¾
ear	ğŸŒ¾
food	ğŸŒ¾
ear of rice	ğŸŒ¾
farming	ğŸŒ¾
crop	ğŸŒ¾
silly	ğŸ™ƒ
flipped	ğŸ™ƒ
notebook	ğŸ’»
macbook	ğŸ’»
personal computer	ğŸ’»
laptop	ğŸ’»
pc	ğŸ’»
baby change station	ğŸš¼
baby change symbol	ğŸš¼
diaper	ğŸš¼
babe	ğŸš¼
human	ğŸš¼
nursery	ğŸš¼
baby symbol	ğŸš¼
crawl	ğŸš¼
small	ğŸš¼
newborn	ğŸš¼
baby	ğŸš¼
flag for ethiopia	ğŸ‡ªğŸ‡¹
regional indicator symbol letters et	ğŸ‡ªğŸ‡¹
wheelchair symbol	â™¿ï¸
mantelpiece clock	ğŸ•°
avocado	ğŸ¥‘
play button	â–¶ï¸
right triangle	â–¶ï¸
mountain	â›°
heavy large circle	â­•ï¸
flag for poland	ğŸ‡µğŸ‡±
regional indicator symbol letters pl	ğŸ‡µğŸ‡±
red cross	ğŸ¥
hospital	ğŸ¥
emergency room	ğŸ¥
medical	ğŸ¥
oar	ğŸš£
boat with paddles	ğŸš£
rowing	ğŸš£
row	ğŸš£
boat	ğŸš£
paddle	ğŸš£
rowboat	ğŸš£
climax	ğŸ‰
popper	ğŸ‰
celebration	ğŸ‰
party	ğŸ‰
tada	ğŸ‰
congratulations	ğŸ‰
victory	ğŸ‰
party popper	ğŸ‰
announcement	ğŸ‰
fountain	â›²ï¸
flag for sudan	ğŸ‡¸ğŸ‡©
regional indicator symbol letters sd	ğŸ‡¸ğŸ‡©
black square for stop	â¹
bow	ğŸ€
pink bow	ğŸ€
wrap	ğŸ€
ribbon	ğŸ€
decorate	ğŸ€
lace	ğŸ€
monkey	ğŸ™‰
hear	ğŸ™‰
sound	ğŸ™‰
kikazaru	ğŸ™‰
ears	ğŸ™‰
light brown man with turban	ğŸ‘³ğŸ¼
flag for uruguay	ğŸ‡ºğŸ‡¾
regional indicator symbol letters uy	ğŸ‡ºğŸ‡¾
red cross	ğŸ‡¨ğŸ‡­
flag for switzerland	ğŸ‡¨ğŸ‡­
swiss flag	ğŸ‡¨ğŸ‡­
regional indicator symbol letters ch	ğŸ‡¨ğŸ‡­
white frowning face	â˜¹
construction	ğŸšœ
machine	ğŸšœ
farming	ğŸšœ
tractor	ğŸšœ
digger	ğŸšœ
farm	ğŸšœ
flag for jamaica	ğŸ‡¯ğŸ‡²
regional indicator symbol letters jm	ğŸ‡¯ğŸ‡²
gold	ğŸ’›
trust	ğŸ’›
happiness	ğŸ’›
friendship	ğŸ’›
compassionate	ğŸ’›
respectful	ğŸ’›
caring	ğŸ’›
happy	ğŸ’›
love	ğŸ’›
yellow	ğŸ’›
heart	ğŸ’›
yellow heart	ğŸ’›
selfless	ğŸ’›
honest	ğŸ’›
gold heart	ğŸ’›
burrito	ğŸŒ¯
wrap	ğŸŒ¯
upwards black arrow	â¬†ï¸
gear	âš™
white guardsman	ğŸ’‚ğŸ»
heavy plus sign	â•
dress	ğŸ‘—
gown	ğŸ‘—
skirt	ğŸ‘—
pollen	ğŸ
bumble bee	ğŸ
honey	ğŸ
buzz	ğŸ
flower	ğŸ
honeybee	ğŸ
queen	ğŸ
pollination	ğŸ
hive	ğŸ
bee	ğŸ
sting	ğŸ
bumble	ğŸ
open lock	ğŸ”“
open padlock	ğŸ”“
unlock	ğŸ”“
archer	â™ï¸
greek	â™ï¸
stars	â™ï¸
sagittarius	â™ï¸
centaur	â™ï¸
sign	â™ï¸
astrology	â™ï¸
constellation	â™ï¸
zodiac	â™ï¸
flag for gambia	ğŸ‡¬ğŸ‡²
regional indicator symbol letters gm	ğŸ‡¬ğŸ‡²
fruit	ğŸ‰
summer	ğŸ‰
watermelon	ğŸ‰
large	ğŸ‰
melon	ğŸ‰
small airplane	ğŸ›©
gold	ğŸŒˆ
rainbow	ğŸŒˆ
primary rainbow	ğŸŒˆ
leprechaun	ğŸŒˆ
color	ğŸŒˆ
diversity	ğŸŒˆ
spectrum	ğŸŒˆ
gay pride	ğŸŒˆ
refract	ğŸŒˆ
pride	ğŸŒˆ
black ear	ğŸ‘‚ğŸ¿
school	ğŸš
city	ğŸš
bus	ğŸš
oncoming bus	ğŸš
transportation	ğŸš
public	ğŸš
front of bus	ğŸš
olive toned older man	ğŸ‘´ğŸ½
slow	ğŸŒ
french	ğŸŒ
garden snail	ğŸŒ
snail	ğŸŒ
slug	ğŸŒ
appetizer	ğŸŒ
escargot	ğŸŒ
postal horn	ğŸ“¯
french horn	ğŸ“¯
bugle	ğŸ“¯
light brown face with ok gesture	ğŸ™†ğŸ¼
presents	ğŸ„
winter	ğŸ„
christmas	ğŸ„
christmas tree	ğŸ„
evergreen	ğŸ„
december	ğŸ„
xmas	ğŸ„
holiday	ğŸ„
xmas tree	ğŸ„
santa	ğŸ„
gifts	ğŸ„
jesus	ğŸ„
ornaments	ğŸ„
flag for mali	ğŸ‡²ğŸ‡±
regional indicator symbol letters ml	ğŸ‡²ğŸ‡±
name tag	ğŸ“›
fire tag	ğŸ“›
tofu on fire	ğŸ“›
name badge	ğŸ“›
deeper brown father christmas	ğŸ…ğŸ¾
flag for cambodia	ğŸ‡°ğŸ‡­
regional indicator symbol letters kh	ğŸ‡°ğŸ‡­
flag for french guiana	ğŸ‡¬ğŸ‡«
regional indicator symbol letters gf	ğŸ‡¬ğŸ‡«
french guinean flag	ğŸ‡¬ğŸ‡«
church	â›ªï¸
flag for cocos islands	ğŸ‡¨ğŸ‡¨
cloud with snow	ğŸŒ¨
ghost	ğŸ‘»
halloween	ğŸ‘»
ghoul	ğŸ‘»
black diamond suit	â™¦ï¸
diamonds	â™¦ï¸
keycap digit two	2âƒ£ï¸
sweet	ğŸ 
potato	ğŸ 
roast	ğŸ 
yam	ğŸ 
potassium	ğŸ 
roasted	ğŸ 
sweet potato	ğŸ 
roasted sweet potato	ğŸ 
flag for finland	ğŸ‡«ğŸ‡®
regional indicator symbol letters fi	ğŸ‡«ğŸ‡®
karaoke	ğŸ¤
audio	ğŸ¤
microphone	ğŸ¤
voice	ğŸ¤
sound	ğŸ¤
mic	ğŸ¤
singing	ğŸ¤
flexed biceps	ğŸ’ª
strong	ğŸ’ª
flexing arm muscles	ğŸ’ª
bicep	ğŸ’ª
feats of strength	ğŸ’ª
muscle	ğŸ’ª
anchor	âš“ï¸
shipyard	âš“ï¸
harbor	âš“ï¸
tattoo	âš“ï¸
boat	âš“ï¸
marina	âš“ï¸
ocean	âš“ï¸
ship	âš“ï¸
sailor	âš“ï¸
sports medal	ğŸ…
shrug	ğŸ¤·
shrugging	ğŸ¤·
clock face seven oclock	ğŸ•–
sun	ğŸŒ
sunface	ğŸŒ
sky	ğŸŒ
sun with face	ğŸŒ
anthropomorphic	ğŸŒ
face	ğŸŒ
smiling sun	ğŸŒ
smiley sun	ğŸŒ
black happy person raising one hand	ğŸ™‹ğŸ¿
soccer ball	âš½ï¸
european	âš½ï¸
football	âš½ï¸
family of two women with two girls	ğŸ‘©â€ğŸ‘©â€ğŸ‘§â€ğŸ‘§
flag for south korea	ğŸ‡°ğŸ‡·
regional indicator symbol letters kr	ğŸ‡°ğŸ‡·
bar chart	ğŸ“Š
oil drum	ğŸ›¢
fog	ğŸŒ
bridge	ğŸŒ
fog bridge	ğŸŒ
foggy city	ğŸŒ
foggy	ğŸŒ
weather	ğŸŒ
sweet	ğŸ­
lick	ğŸ­
candy	ğŸ­
sugar	ğŸ­
lollipop	ğŸ­
stick	ğŸ­
android lollipop	ğŸ­
lollypop	ğŸ­
flag for french polynesia	ğŸ‡µğŸ‡«
nauseated face	ğŸ¤¢
green face	ğŸ¤¢
vomit	ğŸ¤¢
sick	ğŸ¤¢
satellite	ğŸ›°
planet	ğŸŒ
world	ğŸŒ
home	ğŸŒ
globe	ğŸŒ
space	ğŸŒ
asia	ğŸŒ
australia	ğŸŒ
earth	ğŸŒ
fuel pump	â›½
gas pump	â›½
petrol pump	â›½
gas	â›½
olive toned bicyclist	ğŸš´ğŸ½
raised hand with fingers splayed	ğŸ–
five hand	ğŸ–
splayed hand	ğŸ–
wow	ğŸ’¥
fire	ğŸ’¥
collision	ğŸ’¥
impact	ğŸ’¥
red spark	ğŸ’¥
explode	ğŸ’¥
emphasis	ğŸ’¥
boom	ğŸ’¥
bang	ğŸ’¥
bam	ğŸ’¥
collision symbol	ğŸ’¥
white person with pouting face	ğŸ™ğŸ»
railway wagon	ğŸšƒ
railway	ğŸšƒ
railway car	ğŸšƒ
railroad car	ğŸšƒ
car	ğŸšƒ
railcar	ğŸšƒ
railway carriage	ğŸšƒ
coach	ğŸšƒ
train	ğŸšƒ
rail	ğŸšƒ
topper	ğŸ©
beaver	ğŸ©
groom	ğŸ©
period piece	ğŸ©
chimney	ğŸ©
formal wear	ğŸ©
stove	ğŸ©
magician	ğŸ©
london	ğŸ©
hat	ğŸ©
tall	ğŸ©
top hat	ğŸ©
magic	ğŸ©
pipe	ğŸ©
top	ğŸ©
cap	ğŸ©
high	ğŸ©
olive toned bath	ğŸ›€ğŸ½
flag for andorra	ğŸ‡¦ğŸ‡©
regional indicator symbol letters ad	ğŸ‡¦ğŸ‡©
andorran flag	ğŸ‡¦ğŸ‡©
medium white circle	âšªï¸
deeper brown information desk person	ğŸ’ğŸ¾
low brightness symbol	ğŸ”…
decrease brightness	ğŸ”…
summer	ğŸ”…
light brown white left pointing backhand index	ğŸ‘ˆğŸ¼
black horse racing	ğŸ‡ğŸ¿
flag for montserrat	ğŸ‡²ğŸ‡¸
regional indicator symbol letters ms	ğŸ‡²ğŸ‡¸
buds	ğŸ‘…
lick	ğŸ‘…
taste	ğŸ‘…
intimacy	ğŸ‘…
french kiss	ğŸ‘…
playfulness	ğŸ‘…
tease	ğŸ‘…
tasty	ğŸ‘…
silliness	ğŸ‘…
food	ğŸ‘…
silly	ğŸ‘…
tongue	ğŸ‘…
tongue out	ğŸ‘…
playful	ğŸ‘…
mouth	ğŸ‘…
kiss	ğŸ‘…
seafood	ğŸ¤
fried shrimp	ğŸ¤
small	ğŸ¤
shrimp	ğŸ¤
fish	ğŸ¤
prawn	ğŸ¤
fried	ğŸ¤
cat face with wry smile	ğŸ˜¼
confident	ğŸ˜¼
smirk	ğŸ˜¼
confidence	ğŸ˜¼
wry	ğŸ˜¼
smirking cat	ğŸ˜¼
smirking	ğŸ˜¼
keycap digit four	4âƒ£ï¸
clear	ğŸš°
potable	ğŸš°
clean	ğŸš°
pure	ğŸš°
water	ğŸš°
potable water symbol	ğŸš°
h20	ğŸš°
drinkable	ğŸš°
aqua	ğŸš°
canada	ğŸ
canadian	ğŸ
syrup	ğŸ
leaf	ğŸ
tree	ğŸ
maple leaf	ğŸ
maple	ğŸ
light brown ok hand sign	ğŸ‘ŒğŸ¼
mask	ğŸ­
performing	ğŸ­
performing arts	ğŸ­
entertainment	ğŸ­
acting	ğŸ­
masks	ğŸ­
story	ğŸ­
arts	ğŸ­
performance	ğŸ­
pine tree	ğŸŒ²
christmas	ğŸŒ²
evergreen tree	ğŸŒ²
evergreen	ğŸŒ²
needles	ğŸŒ²
tree	ğŸŒ²
white man with gua pi mao	ğŸ‘²ğŸ»
flag for saudi arabia	ğŸ‡¸ğŸ‡¦
regional indicator symbol letters sa	ğŸ‡¸ğŸ‡¦
flag for american samoa	ğŸ‡¦ğŸ‡¸
regional indicator symbol letters as	ğŸ‡¦ğŸ‡¸
american samoan flag	ğŸ‡¦ğŸ‡¸
light brown open hands sign	ğŸ‘ğŸ¼
olive toned baby	ğŸ‘¶ğŸ½
jewish	ğŸ•
temple	ğŸ•
synagog	ğŸ•
synagogue	ğŸ•
thermometer	ğŸŒ¡
hot weather	ğŸŒ¡
temperature	ğŸŒ¡
envelope with downwards arrow above	ğŸ“©
down arrow envelope	ğŸ“©
insert in envelope	ğŸ“©
harvest	ğŸ
spirits	ğŸ
years	ğŸ
bamboo	ğŸ
new year decoration	ğŸ
luck	ğŸ
prosperity	ğŸ
pine	ğŸ
agriculture	ğŸ
farming	ğŸ
new	ğŸ
fortune	ğŸ
longevity	ğŸ
welcome	ğŸ
pine decoration	ğŸ
decoration	ğŸ
kadomatsu	ğŸ
light brown raised hand with part between middle and ring fingers	ğŸ––ğŸ¼
regional indicator symbol letters kn	ğŸ‡°ğŸ‡³
frown	ğŸ™
dejected	ğŸ™
sad person	ğŸ™
person frowning	ğŸ™
rejected	ğŸ™
woman frowning	ğŸ™
sad	ğŸ™
flag for equatorial guinea	ğŸ‡¬ğŸ‡¶
regional indicator symbol letters gq	ğŸ‡¬ğŸ‡¶
flag for tajikistan	ğŸ‡¹ğŸ‡¯
regional indicator symbol letters tj	ğŸ‡¹ğŸ‡¯
growing heart	ğŸ’—
multiple heart	ğŸ’—
triple heart	ğŸ’—
black question mark ornament	â“
hundred points symbol	ğŸ’¯
school	ğŸ’¯
test	ğŸ’¯
100	ğŸ’¯
plus	ğŸ’¯
one hundred	ğŸ’¯
score	ğŸ’¯
a	ğŸ’¯
perfect	ğŸ’¯
quiz	ğŸ’¯
exam	ğŸ’¯
percent	ğŸ’¯
keep it 100	ğŸ’¯
perfect score	ğŸ’¯
on with exclamation mark with left right arrow above	ğŸ”›
on	ğŸ”›
negative squared latin capital letter b	ğŸ…±ï¸
grinning	ğŸ˜€
grin	ğŸ˜€
happy face	ğŸ˜€
smile	ğŸ˜€
smiley face	ğŸ˜€
smiling	ğŸ˜€
smiley	ğŸ˜€
grinning face	ğŸ˜€
pink swirl	ğŸ¥
narutomaki	ğŸ¥
noodles	ğŸ¥
naruto	ğŸ¥
fishcake	ğŸ¥
cake	ğŸ¥
ramen	ğŸ¥
fish	ğŸ¥
swirl	ğŸ¥
kamboko	ğŸ¥
fish cake with swirl design	ğŸ¥
light brown man	ğŸ‘¨ğŸ¼
clock face one oclock	ğŸ•
closed mailbox with lowered flag	ğŸ“ª
olive toned person bowing deeply	ğŸ™‡ğŸ½
fair	ğŸ 
amusement	ğŸ 
carousel	ğŸ 
horse	ğŸ 
merry go round	ğŸ 
entertainment	ğŸ 
fairground	ğŸ 
carousel horse	ğŸ 
park	ğŸ 
carnival	ğŸ 
ride	ğŸ 
bear face	ğŸ»
teddy bear	ğŸ»
cute bear	ğŸ»
golfer	ğŸŒ
golf	ğŸŒ
golf club	ğŸŒ
olive toned person raising both hands in celebration	ğŸ™ŒğŸ½
sedan	ğŸš˜
car hood	ğŸš˜
oncoming automobile	ğŸš˜
car	ğŸš˜
car bonnet	ğŸš˜
front of car	ğŸš˜
automobile	ğŸš˜
weary face	ğŸ˜©
school	ğŸ˜©
finals	ğŸ˜©
tiredness	ğŸ˜©
exhausted	ğŸ˜©
tired	ğŸ˜©
weary	ğŸ˜©
study	ğŸ˜©
sleepy	ğŸ˜©
transportation	ğŸšµ
mountain bicyclist	ğŸšµ
mountain bike	ğŸšµ
pedal	ğŸšµ
bicyclist	ğŸšµ
person on bike	ğŸšµ
bicycle	ğŸšµ
mountain	ğŸšµ
bike	ğŸšµ
flag for cayman islands	ğŸ‡°ğŸ‡¾
regional indicator symbol letters ky	ğŸ‡°ğŸ‡¾
caymanian flag	ğŸ‡°ğŸ‡¾
printer	ğŸ–¨
owl	ğŸ¦‰
clutch	ğŸ‘›
bag	ğŸ‘›
accessory	ğŸ‘›
coin bag	ğŸ‘›
purse	ğŸ‘›
shopping	ğŸ‘›
handbag	ğŸ‘›
money	ğŸ‘›
ladies	ğŸ‘›
wallet	ğŸ‘›
olive toned police officer	ğŸ‘®ğŸ½
lock with ink pen	ğŸ”
lock and pen	ğŸ”
lock with fountain pen	ğŸ”
fruit	ğŸ…
tomato	ğŸ…
italian	ğŸ…
sauce	ğŸ…
wavy dash	ã€°ï¸
hoop	ğŸ€
swish	ğŸ€
rip city	ğŸ€
net	ğŸ€
basketball and hoop	ğŸ€
basketball	ğŸ€
bball	ğŸ€
orange ball	ğŸ€
dribble	ğŸ€
high voltage sign	âš¡ï¸
umbrella	â˜‚
deeper brown thumbs up sign	ğŸ‘ğŸ¾
train platform	ğŸš‰
subway	ğŸš‰
train station	ğŸš‰
train	ğŸš‰
station	ğŸš‰
lion	â™Œ
greek	â™Œ
stars	â™Œ
sign	â™Œ
leo	â™Œ
astrology	â™Œ
constellation	â™Œ
zodiac	â™Œ
regional indicator symbol letters de	ğŸ‡©ğŸ‡ª
german flag	ğŸ‡©ğŸ‡ª
deutsch flag	ğŸ‡©ğŸ‡ª
flag for germany	ğŸ‡©ğŸ‡ª
flag for great britain	ğŸ‡¬ğŸ‡§
british flag	ğŸ‡¬ğŸ‡§
union jack	ğŸ‡¬ğŸ‡§
flag for united kingdom	ğŸ‡¬ğŸ‡§
regional indicator symbol letters gb	ğŸ‡¬ğŸ‡§
uk flag	ğŸ‡¬ğŸ‡§
deeper brown thumbs down sign	ğŸ‘ğŸ¾
straight ruler	ğŸ“
greek	â™Šï¸
stars	â™Šï¸
sign	â™Šï¸
twins	â™Šï¸
astrology	â™Šï¸
gemini	â™Šï¸
constellation	â™Šï¸
zodiac	â™Šï¸
high voltage sign	âš¡
lightning bolt	âš¡
thunderbolt	âš¡
cheese	ğŸŒ”
gibbous	ğŸŒ”
moon	ğŸŒ”
phase	ğŸŒ”
sky	ğŸŒ”
night	ğŸŒ”
waxing	ğŸŒ”
waxing gibbous moon symbol	ğŸŒ”
motor scooter	ğŸ›µ
motor bike	ğŸ›µ
motor cycle	ğŸ›µ
vespa	ğŸ›µ
regional indicator symbol letters vi	ğŸ‡»ğŸ‡®
us virgin islander flag	ğŸ‡»ğŸ‡®
place of worship	ğŸ›
religious building	ğŸ›
white white down pointing backhand index	ğŸ‘‡ğŸ»
north east arrow	â†—ï¸
irritated	ğŸ˜ 
grumpy face	ğŸ˜ 
angry	ğŸ˜ 
vexed	ğŸ˜ 
angry face	ğŸ˜ 
livid	ğŸ˜ 
mad	ğŸ˜ 
fish	ğŸŸ
freshwater fish	ğŸŸ
speaker with one sound wave	ğŸ”‰
reduce volume	ğŸ”‰
fronds	ğŸŒ´
coconut tree	ğŸŒ´
tropical	ğŸŒ´
warm	ğŸŒ´
coconuts	ğŸŒ´
survivor	ğŸŒ´
palm	ğŸŒ´
palm tree	ğŸŒ´
tree	ğŸŒ´
tropical island	ğŸŒ´
flag for iceland	ğŸ‡®ğŸ‡¸
regional indicator symbol letters is	ğŸ‡®ğŸ‡¸
clinking glasses	ğŸ¥‚
champagne glasses	ğŸ¥‚
cheers	ğŸ¥‚
celebration	ğŸ¥‚
air quotes	âœŒï¸
peace sign	âœŒï¸
peace	âœŒï¸
v sign	âœŒï¸
victory hand	âœŒï¸
black telephone	â˜ï¸
telephone	â˜ï¸
rotary phone	â˜ï¸
residence	ğŸ 
ranch	ğŸ 
home	ğŸ 
house	ğŸ 
mansion	ğŸ 
bungalow	ğŸ 
house building	ğŸ 
dwelling	ğŸ 
craftsman	ğŸ 
greek	â™‰ï¸
stars	â™‰ï¸
taurus	â™‰ï¸
sign	â™‰ï¸
astrology	â™‰ï¸
constellation	â™‰ï¸
zodiac	â™‰ï¸
bull	â™‰ï¸
person with ball	â›¹
telescope	ğŸ”­
stargazing	ğŸ”­
morn	ğŸ˜¿
hurt	ğŸ˜¿
crying cat face	ğŸ˜¿
tears	ğŸ˜¿
sad cat	ğŸ˜¿
crying cat	ğŸ˜¿
sob	ğŸ˜¿
sad	ğŸ˜¿
cat	ğŸ˜¿
melancholy	ğŸ˜¿
cry	ğŸ˜¿
somber	ğŸ˜¿
keycap digit eight	8ï¸âƒ£
white mountain bicyclist	ğŸšµğŸ»
bearer	â™’ï¸
greek	â™’ï¸
stars	â™’ï¸
aquarius	â™’ï¸
water	â™’ï¸
sign	â™’ï¸
astrology	â™’ï¸
constellation	â™’ï¸
zodiac	â™’ï¸
construction worker	ğŸ‘·
builder	ğŸ‘·
face with hat	ğŸ‘·
safety helmet	ğŸ‘·
cheese	ğŸŒ›
moon	ğŸŒ›
phase	ğŸŒ›
sky	ğŸŒ›
night	ğŸŒ›
quarter	ğŸŒ›
anthropomorphic	ğŸŒ›
face	ğŸŒ›
first quarter moon with face	ğŸŒ›
first	ğŸŒ›
white face massage	ğŸ’†ğŸ»
white waving hand sign	ğŸ‘‹ğŸ»
white clapping hands sign	ğŸ‘ğŸ»
young	ğŸ¥
cute	ğŸ¥
bird	ğŸ¥
woman	ğŸ¥
chick	ğŸ¥
chicken	ğŸ¥
baby	ğŸ¥
baby chick	ğŸ¥
coffin	âš°
funeral	âš°
casket	âš°
field hockey stick and ball	ğŸ‘
hockey	ğŸ‘
field hockey	ğŸ‘
radio	ğŸ“»
digital radio	ğŸ“»
wireless	ğŸ“»
white medium star	â­
star	â­
yellow star	â­
olive toned swimmer	ğŸŠğŸ½
transportation	ğŸš´
pedal	ğŸš´
bicyclist	ğŸš´
person on bike	ğŸš´
bicycle	ğŸš´
cyclist	ğŸš´
road	ğŸš´
bike	ğŸš´
squared sos	ğŸ†˜
distress signal	ğŸ†˜
emergency	ğŸ†˜
sos	ğŸ†˜
joystick	ğŸ•¹
light brown flexed biceps	ğŸ’ªğŸ¼
flag for cameroon	ğŸ‡¨ğŸ‡²
regional indicator symbol letters cm	ğŸ‡¨ğŸ‡²
cocktail	ğŸ¸
drink	ğŸ¸
mixed	ğŸ¸
bar	ğŸ¸
martini	ğŸ¸
alcohol	ğŸ¸
glass	ğŸ¸
cocktail glass	ğŸ¸
martini glass	ğŸ¸
flag for caribbean netherlands	ğŸ‡§ğŸ‡¶
european post office	ğŸ¤
post office	ğŸ¤
snooker	ğŸ±
magic 8 ball	ğŸ±
pocket ball	ğŸ±
eight ball	ğŸ±
cue ball	ğŸ±
8 ball	ğŸ±
pool	ğŸ±
cue	ğŸ±
billiards	ğŸ±
end with leftwards arrow above	ğŸ”š
end	ğŸ”š
mother	ğŸ‘ª
parents with child	ğŸ‘ª
child	ğŸ‘ª
girl	ğŸ‘ª
father	ğŸ‘ª
family with boy and girl	ğŸ‘ª
boy	ğŸ‘ª
unit	ğŸ‘ª
nuclear family	ğŸ‘ª
family	ğŸ‘ª
group	ğŸ‘ª
deeper brown face massage	ğŸ’†ğŸ¾
concerned face	ğŸ˜°
nervous face	ğŸ˜°
exasperated	ğŸ˜°
sweat	ğŸ˜°
frustrated	ğŸ˜°
face with open mouth and cold sweat	ğŸ˜°
blue face	ğŸ˜°
death	ğŸ’€
skull	ğŸ’€
skeleton	ğŸ’€
grey skull	ğŸ’€
regional indicator symbol letters ag	ğŸ‡¦ğŸ‡¬
bunny rabbit	ğŸ‡
bunny	ğŸ‡
easter	ğŸ‡
reproduction	ğŸ‡
prolific	ğŸ‡
rabbit	ğŸ‡
white older woman	ğŸ‘µğŸ»
greek	â™“ï¸
stars	â™“ï¸
sign	â™“ï¸
astrology	â™“ï¸
pisces	â™“ï¸
fish	â™“ï¸
constellation	â™“ï¸
zodiac	â™“ï¸
kiss with two women	ğŸ‘©â€â¤ï¸â€ğŸ’‹â€ğŸ‘©
light brown person with blond hair	ğŸ‘±ğŸ¼
tsukimi	ğŸ‘
festival	ğŸ‘
moon	ğŸ‘
grass	ğŸ‘
harvest moon	ğŸ‘
dumplings and moon	ğŸ‘
observing	ğŸ‘
rice	ğŸ‘
moon viewing ceremony	ğŸ‘
scene	ğŸ‘
otsukimi	ğŸ‘
autumn	ğŸ‘
viewing	ğŸ‘
fax machine	ğŸ“ 
fax	ğŸ“ 
facsimile	ğŸ“ 
keycap digit three	3âƒ£ï¸
olive toned raised hand	âœ‹ğŸ½
tiger face	ğŸ¯
cute tiger	ğŸ¯
keycap digit two	2ï¸âƒ£
post	ğŸš©
flagstick	ğŸš©
triangular	ğŸš©
triangle	ğŸš©
flagpole	ğŸš©
flag	ğŸš©
triangular flag on post	ğŸš©
red flag	ğŸš©
golf	ğŸš©
light brown nose	ğŸ‘ƒğŸ¼
amex	ğŸ’³
mastercard	ğŸ’³
visa	ğŸ’³
credit	ğŸ’³
signature	ğŸ’³
visa card	ğŸ’³
loan	ğŸ’³
shopping	ğŸ’³
credit card	ğŸ’³
american express	ğŸ’³
purchase	ğŸ’³
card	ğŸ’³
diners club	ğŸ’³
wallet	ğŸ’³
flag for niger	ğŸ‡³ğŸ‡ª
regional indicator symbol letters ne	ğŸ‡³ğŸ‡ª
scales	âš–
scales of justice	âš–
linked chain	ğŸ”—
link symbol	ğŸ”—
hyperlink	ğŸ”—
chain	ğŸ”—
notebook	ğŸ““
black and white book	ğŸ““
flag for swaziland	ğŸ‡¸ğŸ‡¿
regional indicator symbol letters sz	ğŸ‡¸ğŸ‡¿
shopping bags	ğŸ›
chamorro flag	ğŸ‡¬ğŸ‡º
flag for guam	ğŸ‡¬ğŸ‡º
guamanian flag	ğŸ‡¬ğŸ‡º
regional indicator symbol letters gu	ğŸ‡¬ğŸ‡º
black man with gua pi mao	ğŸ‘²ğŸ¿
morn	ğŸ˜­
hurt	ğŸ˜­
crying	ğŸ˜­
tears	ğŸ˜­
loudly crying face	ğŸ˜­
sob	ğŸ˜­
sobbing	ğŸ˜­
sad tears	ğŸ˜­
bawling	ğŸ˜­
sad	ğŸ˜­
melancholy	ğŸ˜­
cry	ğŸ˜­
somber	ğŸ˜­
light brown baby	ğŸ‘¶ğŸ¼
fungi	ğŸ„
toadstool	ğŸ„
food	ğŸ„
shroom	ğŸ„
mushroom	ğŸ„
fungus	ğŸ„
tool	ğŸ”¨
claw hammer	ğŸ”¨
handyman	ğŸ”¨
hammer	ğŸ”¨
olive toned dancer	ğŸ’ƒğŸ½
black baby angel	ğŸ‘¼ğŸ¿
package	ğŸ“¦
flag for honduras	ğŸ‡­ğŸ‡³
regional indicator symbol letters hn	ğŸ‡­ğŸ‡³
alarm clock	â°
clock	â°
alarm	â°
ç¦	ğŸˆ²
forbid	ğŸˆ²
face with cold sweat	ğŸ˜“
hard work	ğŸ˜“
diaphoresis	ğŸ˜“
sad sweat face	ğŸ˜“
clammy	ğŸ˜“
cold	ğŸ˜“
worried	ğŸ˜“
sweat	ğŸ˜“
anxious	ğŸ˜“
sick	ğŸ˜“
eye in speech bubble	ğŸ‘â€ğŸ—¨
i am a witness	ğŸ‘â€ğŸ—¨
light brown raised fist	âœŠğŸ¼
no entry	â›”ï¸
crossed flags	ğŸŒ
two flags	ğŸŒ
cheese	ğŸŒ—
moon	ğŸŒ—
phase	ğŸŒ—
sky	ğŸŒ—
night	ğŸŒ—
quarter	ğŸŒ—
last	ğŸŒ—
last quarter moon symbol	ğŸŒ—
dvd	ğŸ“€
dvd video	ğŸ“€
dvd rom	ğŸ“€
two bump camel	ğŸ«
chinese camel	ğŸ«
desert	ğŸ«
bactrian camel	ğŸ«
wednesday	ğŸ«
sex	ğŸ«
water	ğŸ«
central asia	ğŸ«
hump	ğŸ«
hot	ğŸ«
heat	ğŸ«
hump day	ğŸ«
bactrian	ğŸ«
asian camel	ğŸ«
double bump camel	ğŸ«
camel	ğŸ«
duck	ğŸ¦†
desktop computer	ğŸ–¥
pc tower	ğŸ–¥
imac	ğŸ–¥
light brown rowboat	ğŸš£ğŸ¼
taxicab	ğŸš•
city	ğŸš•
new york taxi	ğŸš•
car	ğŸš•
service	ğŸš•
automobile	ğŸš•
transport	ğŸš•
side of taxi	ğŸš•
taxi	ğŸš•
light brown happy person raising one hand	ğŸ™‹ğŸ¼
clapboard	ğŸ¬
movie	ğŸ¬
clapper	ğŸ¬
film slate	ğŸ¬
board	ğŸ¬
take	ğŸ¬
director	ğŸ¬
clapper board	ğŸ¬
film	ğŸ¬
golf clap	ğŸ‘
applause	ğŸ‘
encouragement	ğŸ‘
clapping hands sign	ğŸ‘
approval	ğŸ‘
clapping	ğŸ‘
enthusiasm	ğŸ‘
sound	ğŸ‘
clap	ğŸ‘
round of applause	ğŸ‘
appreciation	ğŸ‘
flag for latvia	ğŸ‡±ğŸ‡»
regional indicator symbol letters lv	ğŸ‡±ğŸ‡»
light brown person with pouting face	ğŸ™ğŸ¼
stopwatch	â±
flag for bouvet island	ğŸ‡§ğŸ‡»
light brown girl	ğŸ‘§ğŸ¼
racing motorcycle	ğŸ
motorbike	ğŸ
motorcycle	ğŸ
cute	ğŸ’ 
glyph	ğŸ’ 
diamond shape with a dot inside	ğŸ’ 
diamond	ğŸ’ 
cuteness	ğŸ’ 
kawaii	ğŸ’ 
japanese	ğŸ’ 
adorable	ğŸ’ 
white up pointing backhand index	ğŸ‘†
pointing up	ğŸ‘†
middle finger	ğŸ‘†
bird	ğŸ¦
arrow pointing rightwards then curving upwards	â¤´ï¸
happy sweat	ğŸ˜…
smiling face with open mouth and cold sweat	ğŸ˜…
cold	ğŸ˜…
sweat	ğŸ˜…
smiling	ğŸ˜…
exercise	ğŸ˜…
perspiration	ğŸ˜…
cow	ğŸ„
milk	ğŸ„
dairy	ğŸ„
beef	ğŸ„
dairy cow	ğŸ„
bessie	ğŸ„
moo	ğŸ„
small blue diamond	ğŸ”¹
raised back of hand	ğŸ¤š
backhand	ğŸ¤š
peach	ğŸ‘
fruit	ğŸ‘
juicy	ğŸ‘
butt	ğŸ‘
pit	ğŸ‘
regional indicator symbol letter s	ğŸ‡¸
flag for sri lanka	ğŸ‡±ğŸ‡°
regional indicator symbol letters lk	ğŸ‡±ğŸ‡°
black clapping hands sign	ğŸ‘ğŸ¿
camera	ğŸ“·
digital camera	ğŸ“·
woof	ğŸ•
friend	ğŸ•
fido	ğŸ•
dog	ğŸ•
doge	ğŸ•
japanese akita	ğŸ•
pet	ğŸ•
bark	ğŸ•
puppy	ğŸ•
flag for malawi	ğŸ‡²ğŸ‡¼
regional indicator symbol letters mw	ğŸ‡²ğŸ‡¼
tablet	ğŸ’Š
pill	ğŸ’Š
capsule	ğŸ’Š
drugs	ğŸ’Š
heavy large circle	â­•
circle	â­•
red circle	â­•
correct	â­•
deeper brown princess	ğŸ‘¸ğŸ¾
flower	ğŸŒ»
sun	ğŸŒ»
sunflower	ğŸŒ»
seeds	ğŸŒ»
yellow	ğŸŒ»
yellow flower	ğŸŒ»
accept	ğŸ™†
yes	ğŸ™†
okay	ğŸ™†
ballerina	ğŸ™†
face with ok gesture	ğŸ™†
ok	ğŸ™†
hands on head	ğŸ™†
deeper brown runner	ğŸƒğŸ¾
circled ideograph congratulation	ãŠ—ï¸
accommodation	ğŸ¨
hotel	ğŸ¨
motel	ğŸ¨
hospital	ğŸ¨
holiday inn	ğŸ¨
h building	ğŸ¨
high heels	ğŸ‘ 
stiletto	ğŸ‘ 
flag for liechtenstein	ğŸ‡±ğŸ‡®
regional indicator symbol letters li	ğŸ‡±ğŸ‡®
flag for serbia	ğŸ‡·ğŸ‡¸
regional indicator symbol letters rs	ğŸ‡·ğŸ‡¸
travel	ğŸ›ƒ
government	ğŸ›ƒ
check	ğŸ›ƒ
goods	ğŸ›ƒ
foreign	ğŸ›ƒ
customs	ğŸ›ƒ
authority	ğŸ›ƒ
deeper brown bride with veil	ğŸ‘°ğŸ¾
flag for slovenia	ğŸ‡¸ğŸ‡®
regional indicator symbol letters si	ğŸ‡¸ğŸ‡®
ç”³	ğŸˆ¸
request	ğŸˆ¸
monkey	ğŸˆ¸
application form	ğŸˆ¸
lips	ğŸ˜™
kissing	ğŸ˜™
kiss face	ğŸ˜™
smile	ğŸ˜™
kissing face with smiling eyes	ğŸ˜™
smooch	ğŸ˜™
kissy	ğŸ˜™
whistling	ğŸ˜™
whistle	ğŸ˜™
pucker	ğŸ˜™
kiss	ğŸ˜™
high brightness symbol	ğŸ”†
increase brightness	ğŸ”†
summer	ğŸ”†
shadow	ğŸ‘¥
people	ğŸ‘¥
busts in silhouette	ğŸ‘¥
users	ğŸ‘¥
silhouette	ğŸ‘¥
silhouettes	ğŸ‘¥
shadows	ğŸ‘¥
relationship	ğŸ‘¥
members	ğŸ‘¥
user	ğŸ‘¥
accounts	ğŸ‘¥
pound note	ğŸ’·
bills	ğŸ’·
banknote	ğŸ’·
britain	ğŸ’·
paper	ğŸ’·
twenty quid note	ğŸ’·
money	ğŸ’·
currency	ğŸ’·
british	ğŸ’·
banknote with pound sign	ğŸ’·
pound	ğŸ’·
cash	ğŸ’·
zero width joiner	â€
school	ğŸ
fruit	ğŸ
teacher	ğŸ
doctor	ğŸ
empire apple	ğŸ
electronics	ğŸ
red delicious apple	ğŸ
red apple	ğŸ
apple	ğŸ
gala apple	ğŸ
core	ğŸ
red	ğŸ
black haircut	ğŸ’‡ğŸ¿
fist bump	ğŸ‘Š
fisted hand sign	ğŸ‘Š
punch	ğŸ‘Š
bamboo	ğŸ¼
cute	ğŸ¼
bear	ğŸ¼
endearment	ğŸ¼
friendship	ğŸ¼
china	ğŸ¼
cub	ğŸ¼
face	ğŸ¼
black	ğŸ¼
love	ğŸ¼
panda face	ğŸ¼
white	ğŸ¼
panda	ğŸ¼
flag for bulgaria	ğŸ‡§ğŸ‡¬
regional indicator symbol letters bg	ğŸ‡§ğŸ‡¬
bulgarian flag	ğŸ‡§ğŸ‡¬
white person frowning	ğŸ™ğŸ»
olive toned runner	ğŸƒğŸ½
flag for costa rica	ğŸ‡¨ğŸ‡·
regional indicator symbol letters cr	ğŸ‡¨ğŸ‡·
white exclamation mark ornament	â•
olive toned white right pointing backhand index	ğŸ‘‰ğŸ½
transportation	ğŸšŸ
railway	ğŸšŸ
suspension railway	ğŸšŸ
train	ğŸšŸ
rail	ğŸšŸ
suspension	ğŸšŸ
ho ho ho	ğŸ…
presents	ğŸ…
christmas	ğŸ…
jolly	ğŸ…
north pole	ğŸ…
nice	ğŸ…
naughty	ğŸ…
sleigh	ğŸ…
holiday	ğŸ…
father	ğŸ…
father christmas	ğŸ…
santa	ğŸ…
gifts	ğŸ…
santa claus	ğŸ…
saint nick	ğŸ…
flag for morocco	ğŸ‡²ğŸ‡¦
regional indicator symbol letters ma	ğŸ‡²ğŸ‡¦
family of a man and woman with two boys	ğŸ‘¨â€ğŸ‘©â€ğŸ‘¦â€ğŸ‘¦
white raised hand with part between middle and ring fingers	ğŸ––ğŸ»
children crossing	ğŸš¸
children	ğŸš¸
slow	ğŸš¸
caution	ğŸš¸
kids crossing	ğŸš¸
school crossing	ğŸš¸
kids	ğŸš¸
street	ğŸš¸
crosswalk	ğŸš¸
crossing	ğŸš¸
hotel	ğŸ©
adultery	ğŸ©
birth	ğŸ©
heart hospital	ğŸ©
sex	ğŸ©
hospital	ğŸ©
love hotel	ğŸ©
happy	ğŸ©
love heart hotel	ğŸ©
love	ğŸ©
prostitution	ğŸ©
romance	ğŸ©
leisure	ğŸ©
regional indicator symbol letters bb	ğŸ‡§ğŸ‡§
flag for barbados	ğŸ‡§ğŸ‡§
barbadian flag	ğŸ‡§ğŸ‡§
bajan flag	ğŸ‡§ğŸ‡§
black surfer	ğŸ„ğŸ¿
sun behind cloud	â›…
twisted rightwards arrows	ğŸ”€
leaves	ğŸŒ³
rounded tree	ğŸŒ³
deciduous	ğŸŒ³
deciduous tree	ğŸŒ³
color	ğŸŒ³
fall	ğŸŒ³
tree	ğŸŒ³
regional indicator symbol letters cd	ğŸ‡¨ğŸ‡©
sweet	ğŸ¬
candy	ğŸ¬
hard	ğŸ¬
sugar	ğŸ¬
lolly	ğŸ¬
deeper brown construction worker	ğŸ‘·ğŸ¾
boy	ğŸ‘¦
swell	ğŸ„
surfing	ğŸ„
surf	ğŸ„
ocean	ğŸ„
wave	ğŸ„
surfer	ğŸ„
ride	ğŸ„
boy and girl kissing	ğŸ’
couple kissing	ğŸ’
couple love	ğŸ’
man and woman kissing	ğŸ’
kiss	ğŸ’
mahjong tile red dragon	ğŸ€„ï¸
smoke	ğŸš­
no smoking symbol	ğŸš­
cancer	ğŸš­
smoking	ğŸš­
nicotine	ğŸš­
inhale	ğŸš­
cigarette	ğŸš­
lungs	ğŸš­
no	ğŸš­
tar	ğŸš­
cracker	ğŸ˜
rice	ğŸ˜
rice cracker	ğŸ˜
food	ğŸ˜
japanese	ğŸ˜
seaweed	ğŸ˜
deeper brown person frowning	ğŸ™ğŸ¾
city	ğŸš
bus	ğŸš
minibus	ğŸš
transportation	ğŸš
transport	ğŸš
minivan	ğŸš
white ear	ğŸ‘‚ğŸ»
flag for gibraltar	ğŸ‡¬ğŸ‡®
regional indicator symbol letters gi	ğŸ‡¬ğŸ‡®
green book	ğŸ“—
flag for curaÃ§ao	ğŸ‡¨ğŸ‡¼
regional indicator symbol letters cw	ğŸ‡¨ğŸ‡¼
curaÃ§aoan flag	ğŸ‡¨ğŸ‡¼
french	ğŸ®
dessert	ğŸ®
rich	ğŸ®
creme caramel	ğŸ®
cream	ğŸ®
crÃ¨me	ğŸ®
pudding	ğŸ®
butter	ğŸ®
custard	ğŸ®
flan	ğŸ®
brÃ»lÃ©e	ğŸ®
wind blowing face	ğŸŒ¬
blowing wind	ğŸŒ¬
mother nature	ğŸŒ¬
black medium small square	â—¾
greek	â™ï¸
stars	â™ï¸
sign	â™ï¸
libra	â™ï¸
scales	â™ï¸
astrology	â™ï¸
constellation	â™ï¸
zodiac	â™ï¸
flag for northern mariana islands	ğŸ‡²ğŸ‡µ
regional indicator symbol letters mp	ğŸ‡²ğŸ‡µ
black ok hand sign	ğŸ‘ŒğŸ¿
flag for croatia	ğŸ‡­ğŸ‡·
regional indicator symbol letters hr	ğŸ‡­ğŸ‡·
croatian flag	ğŸ‡­ğŸ‡·
bunny	ğŸ‘¯
tap dance	ğŸ‘¯
playboy	ğŸ‘¯
ballet	ğŸ‘¯
showgirl	ğŸ‘¯
cancan	ğŸ‘¯
dancing girls	ğŸ‘¯
dancing	ğŸ‘¯
dancers	ğŸ‘¯
showgirls	ğŸ‘¯
woman with bunny ears	ğŸ‘¯
costume	ğŸ‘¯
factory	ğŸ­
double curly loop	â¿
voicemail	â¿
double curling loop	â¿
flag for micronesia	ğŸ‡«ğŸ‡²
watch	âŒšï¸
frown	ğŸ˜¦
yawning	ğŸ˜¦
sulk	ğŸ˜¦
glower	ğŸ˜¦
frowning face with open mouth	ğŸ˜¦
pout	ğŸ˜¦
sad	ğŸ˜¦
stars	ğŸŒŒ
sky	ğŸŒŒ
planets	ğŸŒŒ
star	ğŸŒŒ
galaxy	ğŸŒŒ
milky	ğŸŒŒ
night sky	ğŸŒŒ
space	ğŸŒŒ
universe	ğŸŒŒ
milky way	ğŸŒŒ
deeper brown fisted hand sign	ğŸ‘ŠğŸ¾
splashing sweat symbol	ğŸ’¦
water drops	ğŸ’¦
splashing water	ğŸ’¦
plewds	ğŸ’¦
family of two women with two boys	ğŸ‘©â€ğŸ‘©â€ğŸ‘¦â€ğŸ‘¦
rock	ğŸ¸
electric	ğŸ¸
acoustic guitar	ğŸ¸
bass guitar	ğŸ¸
music	ğŸ¸
string	ğŸ¸
electric guitar	ğŸ¸
guitar	ğŸ¸
acoustic	ğŸ¸
jam	ğŸ¸
instrument	ğŸ¸
left speech bubble	ğŸ—¨
union	ğŸ‰
league	ğŸ‰
sport	ğŸ‰
ball	ğŸ‰
team	ğŸ‰
rugby football	ğŸ‰
football	ğŸ‰
rugby	ğŸ‰
england	ğŸ‰
family of two men with two girls	ğŸ‘¨â€ğŸ‘¨â€ğŸ‘§â€ğŸ‘§
hourglass with flowing sand	â³
chains	â›“
white princess	ğŸ‘¸ğŸ»
plane	âœˆï¸
flight	âœˆï¸
jumbo	âœˆï¸
airbus	âœˆï¸
flying	âœˆï¸
jet	âœˆï¸
airlines	âœˆï¸
travel	âœˆï¸
aeroplane	âœˆï¸
boeing	âœˆï¸
airport	âœˆï¸
airplane	âœˆï¸
fly	âœˆï¸
input symbol for latin capital letters	ğŸ” 
abcd	ğŸ” 
uppercase	ğŸ” 
dromedary	ğŸª
single bump camel	ğŸª
indian camel	ğŸª
desert	ğŸª
middle east	ğŸª
wednesday	ğŸª
arabian camel	ğŸª
sex	ğŸª
water	ğŸª
one bump camel	ğŸª
hump	ğŸª
hot	ğŸª
heat	ğŸª
hump day	ğŸª
dromedary camel	ğŸª
camel	ğŸª
white face with ok gesture	ğŸ™†ğŸ»
keycap asterisk	*âƒ£
elephant	ğŸ˜
bento	ğŸ±
convenient	ğŸ±
rice	ğŸ±
bento box	ğŸ±
obento	ğŸ±
box	ğŸ±
lunch box	ğŸ±
japanese	ğŸ±
meal	ğŸ±
lunchbox	ğŸ±
nail polish	ğŸ’…
beauty	ğŸ’…
manicure	ğŸ’…
nails	ğŸ’…
day calendar	ğŸ“†
desk calendar	ğŸ“†
scooter	ğŸ›´
cheese	ğŸŒ“
moon	ğŸŒ“
phase	ğŸŒ“
sky	ğŸŒ“
night	ğŸŒ“
quarter	ğŸŒ“
first	ğŸŒ“
first quarter moon symbol	ğŸŒ“
lower left crayon	ğŸ–
drum with drumsticks	ğŸ¤º
clock face ten oclock	ğŸ•™
hollywood	ğŸ¥
camera	ğŸ¥
motion	ğŸ¥
movie	ğŸ¥
camcorder	ğŸ¥
movie camera	ğŸ¥
video	ğŸ¥
picture	ğŸ¥
film camera	ğŸ¥
trouble	ğŸ˜ˆ
red devil	ğŸ˜ˆ
happy devil	ğŸ˜ˆ
smiling face with horns	ğŸ˜ˆ
devil	ğŸ˜ˆ
devil horns	ğŸ˜ˆ
purple devil	ğŸ˜ˆ
horns	ğŸ˜ˆ
impish	ğŸ˜ˆ
olive toned pedestrian	ğŸš¶ğŸ½
vibration mode	ğŸ“³
silent mode	ğŸ“³
phone heart	ğŸ“³
eyeballs	ğŸ‘€
shifty eyes	ğŸ‘€
seeing	ğŸ‘€
eyesight	ğŸ‘€
eyes	ğŸ‘€
wide eyes	ğŸ‘€
noodles	ğŸ
spaghetti	ğŸ
tomato	ğŸ
italian	ğŸ
spaghetti bolognese	ğŸ
pasta	ğŸ
sauce	ğŸ
interstate	ğŸ›£
highway	ğŸ›£
motorway	ğŸ›£
road	ğŸ›£
uv	ğŸŒ‚
moisture	ğŸŒ‚
closed	ğŸŒ‚
collapsed umbrella	ğŸŒ‚
sun	ğŸŒ‚
rain	ğŸŒ‚
pink umbrella	ğŸŒ‚
ultraviolet	ğŸŒ‚
umbrella	ğŸŒ‚
protection	ğŸŒ‚
closed umbrella	ğŸŒ‚
squared katakana sa	ğŸˆ‚ï¸
regional indicator symbol letters tt	ğŸ‡¹ğŸ‡¹
flag for vatican city	ğŸ‡»ğŸ‡¦
tulip	ğŸŒ·
easter	ğŸŒ·
flower	ğŸŒ·
bulb	ğŸŒ·
spring	ğŸŒ·
no cell phones	ğŸ“µ
no mobile phones	ğŸ“µ
no phones	ğŸ“µ
no smartphones	ğŸ“µ
flag for guadeloupe	ğŸ‡¬ğŸ‡µ
regional indicator symbol letters gp	ğŸ‡¬ğŸ‡µ
guadeloupean flag	ğŸ‡¬ğŸ‡µ
short	ğŸ°
dessert	ğŸ°
cake	ğŸ°
strawberry shortcake	ğŸ°
shortcake	ğŸ°
strawberry	ğŸ°
piece of cake	ğŸ°
ecstatic	ğŸ˜
silly	ğŸ˜
tongue	ğŸ˜
tongue out	ğŸ˜
playful	ğŸ˜
kidding	ğŸ˜
white question mark ornament	â”
flag for peru	ğŸ‡µğŸ‡ª
regional indicator symbol letters pe	ğŸ‡µğŸ‡ª
hourglass	âŒ›ï¸
flag for san marino	ğŸ‡¸ğŸ‡²
regional indicator symbol letters sm	ğŸ‡¸ğŸ‡²
flag for angola	ğŸ‡¦ğŸ‡´
regional indicator symbol letters ao	ğŸ‡¦ğŸ‡´
keycap digit four	4ï¸âƒ£
studio microphone	ğŸ™
regional indicator symbol letter j	ğŸ‡¯
bedtime	ğŸ’¤
sleep	ğŸ’¤
boring	ğŸ’¤
zzz	ğŸ’¤
sleeping symbol	ğŸ’¤
deeper brown person bowing deeply	ğŸ™‡ğŸ¾
card index dividers	ğŸ—‚
statue of liberty	ğŸ—½
new york	ğŸ—½
regional indicator symbol letters ci	ğŸ‡¨ğŸ‡®
event	ğŸª
big	ğŸª
tent	ğŸª
circus tent	ğŸª
carnival	ğŸª
top	ğŸª
circus	ğŸª
big top	ğŸª
canvas	ğŸª
bell with cancellation stroke	ğŸ”•
ringer disabled	ğŸ”•
notifications	ğŸ”•
smoke	ğŸš¬
cancer	ğŸš¬
smoking	ğŸš¬
nicotine	ğŸš¬
smoking symbol	ğŸš¬
inhale	ğŸš¬
cigarette	ğŸš¬
lungs	ğŸš¬
tar	ğŸš¬
scared	ğŸ˜¨
frightened	ğŸ˜¨
fearful	ğŸ˜¨
surprised	ğŸ˜¨
fearful face	ğŸ˜¨
fear	ğŸ˜¨
kiss mark	ğŸ’‹
kissing lips	ğŸ’‹
exclamation question mark	â‰ï¸
4th	ğŸ†
idea	ğŸ†
independence	ğŸ†
sky	ğŸ†
celebration	ğŸ†
rocket	ğŸ†
explosion	ğŸ†
excitement	ğŸ†
july	ğŸ†
firework	ğŸ†
fireworks	ğŸ†
olive toned information desk person	ğŸ’ğŸ½
dirty	ğŸš±
no water	ğŸš±
gross	ğŸš±
not drinkable	ğŸš±
water	ğŸš±
h20	ğŸš±
no drinking water	ğŸš±
aqua	ğŸš±
flag for vietnam	ğŸ‡»ğŸ‡³
regional indicator symbol letters vn	ğŸ‡»ğŸ‡³
school	ğŸšŒ
city	ğŸšŒ
bus	ğŸšŒ
transportation	ğŸšŒ
school bus	ğŸšŒ
public	ğŸšŒ
flag for lesotho	ğŸ‡±ğŸ‡¸
regional indicator symbol letters ls	ğŸ‡±ğŸ‡¸
deeper brown ear	ğŸ‘‚ğŸ¾
lock	ğŸ”’
closed lock	ğŸ”’
padlock	ğŸ”’
asian man	ğŸ‘²
qing	ğŸ‘²
asian	ğŸ‘²
skullcap	ğŸ‘²
man with gua pi mao	ğŸ‘²
chinese	ğŸ‘²
handbag	ğŸ‘œ
bag	ğŸ‘œ
cloud	â˜ï¸
flag for macau	ğŸ‡²ğŸ‡´
regional indicator symbol letters mo	ğŸ‡²ğŸ‡´
deeper brown older man	ğŸ‘´ğŸ¾
olive toned bride with veil	ğŸ‘°ğŸ½
postbox	ğŸ“®
frog face	ğŸ¸
frog	ğŸ¸
kermit	ğŸ¸
halo	ğŸ˜‡
circle	ğŸ˜‡
angel	ğŸ˜‡
innocent	ğŸ˜‡
ring	ğŸ˜‡
smiling face with halo	ğŸ˜‡
holding hands	ğŸ‘«
straight couple	ğŸ‘«
man and woman holding hands	ğŸ‘«
heterosexual couple	ğŸ‘«
white pedestrian	ğŸš¶ğŸ»
cranky	ğŸŠ
alligator	ğŸŠ
croc	ğŸŠ
crocodile	ğŸŠ
gator	ğŸŠ
karaoke	ã€½ï¸
song	ã€½ï¸
music	ã€½ï¸
m	ã€½ï¸
part alternation mark	ã€½ï¸
letter	ã€½ï¸
sing	ã€½ï¸
vocal	ã€½ï¸
japanese	ã€½ï¸
cue	ã€½ï¸
olive toned thumbs down sign	ğŸ‘ğŸ½
sheep	ğŸ
ram	ğŸ
male	ğŸ
horns	ğŸ
horn	ğŸ
lower left fountain pen	ğŸ–‹
deeper brown boy	ğŸ‘¦ğŸ¾
japanese post office	ğŸ£
japan post	ğŸ£
japanese postal mark	ğŸ£
squeans	ğŸ’«
circle and star	ğŸ’«
dizzy symbol	ğŸ’«
star	ğŸ’«
starburst	ğŸ’«
drunk	ğŸ’«
intoxicated	ğŸ’«
dizzy	ğŸ’«
sick	ğŸ’«
electric	ğŸ¹
keyboard	ğŸ¹
organ	ğŸ¹
music	ğŸ¹
piano	ğŸ¹
musical keyboard	ğŸ¹
instrument	ğŸ¹
light brown runner	ğŸƒğŸ¼
cucumber	ğŸ¥’
pickle	ğŸ¥’
gherkin	ğŸ¥’
desert	ğŸœ
squared katakana koko	ğŸˆ
here	ğŸˆ
destination	ğŸˆ
clipboard	ğŸ“‹
glowing	ğŸŒŸ
classic	ğŸŒŸ
exploding star	ğŸŒŸ
star	ğŸŒŸ
glow	ğŸŒŸ
points	ğŸŒŸ
shining star	ğŸŒŸ
gold star	ğŸŒŸ
five	ğŸŒŸ
glowing star	ğŸŒŸ
heart with arrow	ğŸ’˜
cupid arrow	ğŸ’˜
lovestruck	ğŸ’˜
flag for yemen	ğŸ‡¾ğŸ‡ª
regional indicator symbol letters ye	ğŸ‡¾ğŸ‡ª
pick	â›
black circle for record	âº
white down pointing backhand index	ğŸ‘‡
pointing down	ğŸ‘‡
bank	ğŸ¦
bank branch	ğŸ¦
bk	ğŸ¦
flag for kenya	ğŸ‡°ğŸ‡ª
regional indicator symbol letters ke	ğŸ‡°ğŸ‡ª
kenyan flag	ğŸ‡°ğŸ‡ª
sleeping accommodation	ğŸ›Œ
negative squared latin capital letter a	ğŸ…°ï¸
keycap digit seven	7âƒ£ï¸
sight	ğŸ™ˆ
monkey covering eyes	ğŸ™ˆ
monkey	ğŸ™ˆ
vision	ğŸ™ˆ
eyes	ğŸ™ˆ
mizaru	ğŸ™ˆ
see	ğŸ™ˆ
cheeky monkey	ğŸ™ˆ
pear	ğŸ
fruit	ğŸ
shape	ğŸ
hungry	ğŸ˜‹
face savouring delicious food	ğŸ˜‹
savoring	ğŸ˜‹
tasty	ğŸ˜‹
eat	ğŸ˜‹
yummy	ğŸ˜‹
savory	ğŸ˜‹
yum	ğŸ˜‹
food	ğŸ˜‹
delicious	ğŸ˜‹
goofy	ğŸ˜‹
heavy heart exclamation mark ornament	â£
heart above dot	â£
daughter	ğŸ‘¸
princess	ğŸ‘¸
queen	ğŸ‘¸
blonde girl	ğŸ‘¸
disney	ğŸ‘¸
girl with crown	ğŸ‘¸
royalty	ğŸ‘¸
girl with tiara	ğŸ‘¸
king	ğŸ‘¸
royal	ğŸ‘¸
phone with arrow	ğŸ“²
mobile phone with rightwards arrow at left	ğŸ“²
phone call	ğŸ“²
pointing to phone	ğŸ“²
flag for south africa	ğŸ‡¿ğŸ‡¦
regional indicator symbol letters za	ğŸ‡¿ğŸ‡¦
white baby angel	ğŸ‘¼ğŸ»
american dollar	ğŸ’µ
bills	ğŸ’µ
banknote	ğŸ’µ
dollar	ğŸ’µ
canada	ğŸ’µ
banknote with dollar sign	ğŸ’µ
united states	ğŸ’µ
paper	ğŸ’µ
dollar bill	ğŸ’µ
money	ğŸ’µ
currency	ğŸ’µ
australia	ğŸ’µ
cash	ğŸ’µ
rice ball	ğŸ™
triangle rice	ğŸ™
rice	ğŸ™
ball	ğŸ™
nori	ğŸ™
japanese	ğŸ™
white	ğŸ™
seaweed	ğŸ™
input symbol for symbols	ğŸ”£
symbols	ğŸ”£
symbol input	ğŸ”£
white man	ğŸ‘¨ğŸ»
anticlockwise downwards and upwards open circle arrows	ğŸ”„
refresh icon	ğŸ”„
reverse arrows	ğŸ”„
orange	ğŸŠ
tangerine	ğŸŠ
mandarin	ğŸŠ
citrus	ğŸŠ
ant	ğŸœ
queen	ğŸœ
black ant	ğŸœ
bullant	ğŸœ
insect	ğŸœ
team	ğŸœ
snow	ğŸ¿
powder	ğŸ¿
poles	ğŸ¿
winter	ğŸ¿
slalom	ğŸ¿
skis	ğŸ¿
ski and ski boot	ğŸ¿
skiing	ğŸ¿
ski	ğŸ¿
downhill	ğŸ¿
alpine	ğŸ¿
freestyle	ğŸ¿
mountain	ğŸ¿
trident emblem	ğŸ”±
face with thermometer	ğŸ¤’
sick	ğŸ¤’
ill	ğŸ¤’
light brown police officer	ğŸ‘®ğŸ¼
camping	ğŸ•
campsite	ğŸ•
triumph	ğŸ˜¤
mad face	ğŸ˜¤
airing of grievances	ğŸ˜¤
frustrated	ğŸ˜¤
steam	ğŸ˜¤
steaming	ğŸ˜¤
face with look of triumph	ğŸ˜¤
breath	ğŸ˜¤
archer	â™
greek	â™
stars	â™
sagittarius	â™
centaur	â™
sign	â™
astrology	â™
constellation	â™
zodiac	â™
flag for christmas island	ğŸ‡¨ğŸ‡½
christmas island flag	ğŸ‡¨ğŸ‡½
outbox tray	ğŸ“¤
outbox	ğŸ“¤
flag for bahrain	ğŸ‡§ğŸ‡­
regional indicator symbol letters bh	ğŸ‡§ğŸ‡­
bahrani flag	ğŸ‡§ğŸ‡­
bahrainian flag	ğŸ‡§ğŸ‡­
pleased	ğŸ˜Œ
relieved face	ğŸ˜Œ
relieved	ğŸ˜Œ
satisfied	ğŸ˜Œ
content	ğŸ˜Œ
phew	ğŸ˜Œ
relief	ğŸ˜Œ
white ok hand sign	ğŸ‘ŒğŸ»
sparkles	âœ¨
stars	âœ¨
sparkle	âœ¨
dagger knife	ğŸ—¡
knife weapon	ğŸ—¡
sweet	ğŸª
chocolate	ğŸª
dessert	ğŸª
chocolate cookie	ğŸª
cookie	ğŸª
biscuit	ğŸª
white dancer	ğŸ’ƒğŸ»
greek	â™‹
stars	â™‹
crab	â™‹
sign	â™‹
cancer	â™‹
astrology	â™‹
constellation	â™‹
zodiac	â™‹
prayer beads	ğŸ“¿
rosary beads	ğŸ“¿
dhikr beads	ğŸ“¿
white open hands sign	ğŸ‘ğŸ»
flag for austria	ğŸ‡¦ğŸ‡¹
regional indicator symbol letters at	ğŸ‡¦ğŸ‡¹
austrian flag	ğŸ‡¦ğŸ‡¹
flag for oman	ğŸ‡´ğŸ‡²
regional indicator symbol letters om	ğŸ‡´ğŸ‡²
deeper brown haircut	ğŸ’‡ğŸ¾
win	ğŸ†
show	ğŸ†
reward	ğŸ†
winners trophy	ğŸ†
trophy	ğŸ†
achievement	ğŸ†
medal	ğŸ†
championship trophy	ğŸ†
first	ğŸ†
place	ğŸ†
light brown white down pointing backhand index	ğŸ‘‡ğŸ¼
light brown white right pointing backhand index	ğŸ‘‰ğŸ¼
rage	ğŸ˜¡
irate	ğŸ˜¡
grumpy face	ğŸ˜¡
mad face	ğŸ˜¡
anger	ğŸ˜¡
pout	ğŸ˜¡
angry face	ğŸ˜¡
red face	ğŸ˜¡
pouting face	ğŸ˜¡
heavy exclamation mark symbol	â—ï¸
birthday	ğŸŠ
win	ğŸŠ
confetti	ğŸŠ
party	ğŸŠ
confetti ball	ğŸŠ
ball	ğŸŠ
new years	ğŸŠ
congratulations	ğŸŠ
celebrate	ğŸŠ
wedding	ğŸŠ
flag for tokelau	ğŸ‡¹ğŸ‡°
deeper brown raised hand	âœ‹ğŸ¾
flag for guatemala	ğŸ‡¬ğŸ‡¹
regional indicator symbol letters gt	ğŸ‡¬ğŸ‡¹
microscope	ğŸ”¬
magnify	ğŸ”¬
science	ğŸ”¬
snowman without snow	â›„ï¸
white medium star	â­ï¸
grinning face with smiling eyes	ğŸ˜
grinning	ğŸ˜
grin	ğŸ˜
smile	ğŸ˜
freezing	ğŸ˜
cold	ğŸ˜
frustrated	ğŸ˜
smiling	ğŸ˜
smiley	ğŸ˜
hammer and wrench	ğŸ› 
cd rom	ğŸ’¿
compact disc	ğŸ’¿
cd	ğŸ’¿
optical disc	ğŸ’¿
pistol	ğŸ”«
gun	ğŸ”«
revolver	ğŸ”«
nobel	ğŸ°
stronghold	ğŸ°
fortress	ğŸ°
fortified	ğŸ°
european	ğŸ°
disneyland	ğŸ°
residence	ğŸ°
princess	ğŸ°
turrets	ğŸ°
prince	ğŸ°
queen	ğŸ°
disney	ğŸ°
moat	ğŸ°
lord	ğŸ°
fort	ğŸ°
european castle	ğŸ°
royalty	ğŸ°
castle	ğŸ°
king	ğŸ°
tower	ğŸ°
church wedding	ğŸ’’
marriage	ğŸ’’
church heart	ğŸ’’
wedding	ğŸ’’
flag for japan	ğŸ‡¯ğŸ‡µ
regional indicator symbol letters jp	ğŸ‡¯ğŸ‡µ
japanese flag	ğŸ‡¯ğŸ‡µ
young	ğŸ¤
cute	ğŸ¤
bird	ğŸ¤
woman	ğŸ¤
yellow bird	ğŸ¤
chick	ğŸ¤
chicken	ğŸ¤
baby	ğŸ¤
baby chick	ğŸ¤
shark	ğŸ¦ˆ
jaws	ğŸ¦ˆ
black nail polish	ğŸ’…ğŸ¿
search icon	ğŸ”
magnifying glass	ğŸ”
detective	ğŸ”
magnifier	ğŸ”
investigator	ğŸ”
details	ğŸ”
detail	ğŸ”
polo shirt	ğŸ‘•
tee shirt	ğŸ‘•
awkward	ğŸ˜¬
nervous	ğŸ˜¬
grimace	ğŸ˜¬
foot in mouth	ğŸ˜¬
grimacing face	ğŸ˜¬
eek	ğŸ˜¬
pain	ğŸ˜¬
disapprove	ğŸ˜¬
battery	ğŸ”‹
phone battery	ğŸ”‹
aa battery	ğŸ”‹
pager	ğŸ“Ÿ
beeper	ğŸ“Ÿ
bleeper	ğŸ“Ÿ
olive toned white left pointing backhand index	ğŸ‘ˆğŸ½
deeper brown horse racing	ğŸ‡ğŸ¾
flag for guinea	ğŸ‡¬ğŸ‡³
regional indicator symbol letters gn	ğŸ‡¬ğŸ‡³
flag for palau	ğŸ‡µğŸ‡¼
regional indicator symbol letters pw	ğŸ‡µğŸ‡¼
olive toned flexed biceps	ğŸ’ªğŸ½
train	ğŸšˆ
light	ğŸšˆ
rail	ğŸšˆ
light rail	ğŸšˆ
wash	ğŸ›€
bathroom	ğŸ›€
shampoo	ğŸ›€
clean	ğŸ›€
hot bath	ğŸ›€
bubble	ğŸ›€
person in bath	ğŸ›€
water	ğŸ›€
bathing	ğŸ›€
tub	ğŸ›€
soap	ğŸ›€
soak	ğŸ›€
lather	ğŸ›€
basin	ğŸ›€
bath	ğŸ›€
sedan	ğŸš—
side of car	ğŸš—
car	ğŸš—
automobile	ğŸš—
red car	ğŸš—
page facing up	ğŸ“„
printed page	ğŸ“„
light brown person with folded hands	ğŸ™ğŸ¼
fallen leaf	ğŸ‚
fall leaves	ğŸ‚
deciduous	ğŸ‚
color	ğŸ‚
fall	ğŸ‚
leaf	ğŸ‚
brown leaves	ğŸ‚
autumn	ğŸ‚
autumn leaves	ğŸ‚
humpback whale	ğŸ‹
massive	ğŸ‹
blubber	ğŸ‹
whale	ğŸ‹
fat	ğŸ‹
large	ğŸ‹
bloated	ğŸ‹
teacup without handle	ğŸµ
tea	ğŸµ
teacup	ğŸµ
drink	ğŸµ
leaf	ğŸµ
hot	ğŸµ
beverage	ğŸµ
haircut	ğŸ’‡
cutting hair	ğŸ’‡
hairdresser	ğŸ’‡
olive toned thumbs up sign	ğŸ‘ğŸ½
sexy	ğŸ†
leopard	ğŸ†
spotted	ğŸ†
spot	ğŸ†
jaguar	ğŸ†
cat	ğŸ†
african leopard	ğŸ†
spiritual	ğŸ
spirits	ğŸ
furin	ğŸ
music	ğŸ
chime	ğŸ
protective	ğŸ
wind bell	ğŸ
fÅ«rin	ğŸ
wind	ğŸ
sound	ğŸ
bell	ğŸ
soothing	ğŸ
wind chime	ğŸ
jellyfish	ğŸ
instrument	ğŸ
flag for european union	ğŸ‡ªğŸ‡º
eu flag	ğŸ‡ªğŸ‡º
european flag	ğŸ‡ªğŸ‡º
watch	âŒš
wrist watch	âŒš
timepiece	âŒš
apple watch	âŒš
grey rat	ğŸ€
crooked	ğŸ€
rodent	ğŸ€
rat	ğŸ€
snitch	ğŸ€
fog	ğŸŒ«
flag for fiji	ğŸ‡«ğŸ‡¯
regional indicator symbol letters fj	ğŸ‡«ğŸ‡¯
flag for canary islands	ğŸ‡®ğŸ‡¨
kimono	ğŸ‘˜
japanese dress	ğŸ‘˜
dressing gown	ğŸ‘˜
family of two men with one boy	ğŸ‘¨â€ğŸ‘¨â€ğŸ‘¦
black guardsman	ğŸ’‚ğŸ¿
volleyball	ğŸ
flag for mayotte	ğŸ‡¾ğŸ‡¹
fire	ğŸ²
head	ğŸ²
legendary	ğŸ²
myth	ğŸ²
dragon head	ğŸ²
dragon	ğŸ²
dragon face	ğŸ²
winning	ğŸ™Œ
praise hands	ğŸ™Œ
banzai	ğŸ™Œ
hallelujah	ğŸ™Œ
person raising both hands in celebration	ğŸ™Œ
yay	ğŸ™Œ
two hands	ğŸ™Œ
magic	ğŸ™Œ
woot	ğŸ™Œ
festivus miracle	ğŸ™Œ
tropical fish	ğŸ 
fish	ğŸ 
bomb	ğŸ’£
boat	ğŸš¤
ski	ğŸš¤
motorboat	ğŸš¤
speedboat	ğŸš¤
power	ğŸš¤
motor	ğŸš¤
speed	ğŸš¤
powerboat	ğŸš¤
kaaba	ğŸ•‹
mecca	ğŸ•‹
socially awkward penguin	ğŸ§
little penguin	ğŸ§
penguin	ğŸ§
cute penguin	ğŸ§
olive toned older woman	ğŸ‘µğŸ½
deeper brown clapping hands sign	ğŸ‘ğŸ¾
deeper brown waving hand sign	ğŸ‘‹ğŸ¾
flag for italy	ğŸ‡®ğŸ‡¹
regional indicator symbol letters it	ğŸ‡®ğŸ‡¹
italian flag	ğŸ‡®ğŸ‡¹
school	ğŸ’®
student	ğŸ’®
teacher	ğŸ’®
brilliance	ğŸ’®
well done stamp	ğŸ’®
intelligence	ğŸ’®
flower	ğŸ’®
score	ğŸ’®
white flower	ğŸ’®
paper doily	ğŸ’®
grade	ğŸ’®
praise	ğŸ’®
homework	ğŸ’®
assignment	ğŸ’®
white	ğŸ’®
cherry blossom	ğŸ’®
flag for malta	ğŸ‡²ğŸ‡¹
regional indicator symbol letters mt	ğŸ‡²ğŸ‡¹
maltese flag	ğŸ‡²ğŸ‡¹
greek	â™‘ï¸
stars	â™‘ï¸
capricorn	â™‘ï¸
sign	â™‘ï¸
astrology	â™‘ï¸
constellation	â™‘ï¸
zodiac	â™‘ï¸
monkey face	ğŸµ
monkey head	ğŸµ
olive toned man	ğŸ‘¨ğŸ½
fuel pump	â›½ï¸
gas	â›½ï¸
closed mailbox with raised flag	ğŸ“«
serve	ğŸ¦
dessert	ğŸ¦
soft	ğŸ¦
icecream	ğŸ¦
yogurt	ğŸ¦
dairy	ğŸ¦
cone	ğŸ¦
cold	ğŸ¦
cream	ğŸ¦
ice	ğŸ¦
soft ice cream	ğŸ¦
mr whippy	ğŸ¦
soft serve	ğŸ¦
cocktail	ğŸ¹
fruit	ğŸ¹
tropical	ğŸ¹
pina	ğŸ¹
pineapple	ğŸ¹
drink	ğŸ¹
mixed	ğŸ¹
fruit punch	ğŸ¹
coconut	ğŸ¹
tropical drink	ğŸ¹
umbrella	ğŸ¹
punch	ğŸ¹
flag for portugal	ğŸ‡µğŸ‡¹
regional indicator symbol letters pt	ğŸ‡µğŸ‡¹
girl	ğŸ‘§
duty	ğŸ’œ
purple	ğŸ’œ
sensitive	ğŸ’œ
violet	ğŸ’œ
compassionate	ğŸ’œ
purple heart	ğŸ’œ
understanding	ğŸ’œ
veteran	ğŸ’œ
sacrifice	ğŸ’œ
love	ğŸ’œ
compassion	ğŸ’œ
royalty	ğŸ’œ
heart	ğŸ’œ
honor	ğŸ’œ
rosette	ğŸµ
black woman	ğŸ‘©ğŸ¿
keycap ten	ğŸ”Ÿ
number 10	ğŸ”Ÿ
flag for united arab emirates	ğŸ‡¦ğŸ‡ª
regional indicator symbol letters ae	ğŸ‡¦ğŸ‡ª
light brown person raising both hands in celebration	ğŸ™ŒğŸ¼
flag for liberia	ğŸ‡±ğŸ‡·
regional indicator symbol letters lr	ğŸ‡±ğŸ‡·
slice of pizza	ğŸ•
pie	ğŸ•
italy	ğŸ•
pepperoni pizza	ğŸ•
slice	ğŸ•
peperoni	ğŸ•
pizza	ğŸ•
italian	ğŸ•
new york	ğŸ•
hand with first and second fingers crossed	ğŸ¤
fingers crossed	ğŸ¤
good luck	ğŸ¤
down triangle	ğŸ”½
fruit	ğŸ†
purple	ğŸ†
aubergine	ğŸ†
penis	ğŸ†
eggplant	ğŸ†
purple vegetable	ğŸ†
old key	ğŸ—
regional indicator symbol letter w	ğŸ‡¼
flag for norway	ğŸ‡³ğŸ‡´
regional indicator symbol letters no	ğŸ‡³ğŸ‡´
norwegian flag	ğŸ‡³ğŸ‡´
halo	ğŸ‘¼
baby angel	ğŸ‘¼
angel	ğŸ‘¼
cherub	ğŸ‘¼
cupid	ğŸ‘¼
wings	ğŸ‘¼
baby	ğŸ‘¼
putto	ğŸ‘¼
flag for tanzania	ğŸ‡¹ğŸ‡¿
regional indicator symbol letters tz	ğŸ‡¹ğŸ‡¿
white up pointing index	â˜ï¸
pointing up	â˜ï¸
secret	â˜ï¸
clock face two oclock	ğŸ•‘
gamble	ğŸ°
poker machine	ğŸ°
slot machine	ğŸ°
luck	ğŸ°
casino	ğŸ°
fruit machine	ğŸ°
machine	ğŸ°
gambling	ğŸ°
slots	ğŸ°
slot	ğŸ°
toilet sign	ğŸš»
shared	ğŸš»
bathroom	ğŸš»
unisex	ğŸš»
toilet	ğŸš»
man	ğŸš»
bathroom sign	ğŸš»
sign	ğŸš»
woman	ğŸš»
restroom	ğŸš»
womans hat	ğŸ‘’
hat	ğŸ‘’
ladies hat	ğŸ‘’
funeral urn	âš±
plant	ğŸŒ¿
cook	ğŸŒ¿
cooking	ğŸŒ¿
spice	ğŸŒ¿
crop	ğŸŒ¿
herb	ğŸŒ¿
flag for gabon	ğŸ‡¬ğŸ‡¦
regional indicator symbol letters ga	ğŸ‡¬ğŸ‡¦
gabonese flag	ğŸ‡¬ğŸ‡¦
closed book	ğŸ“•
red book	ğŸ“•
black father christmas	ğŸ…ğŸ¿
olive toned person with blond hair	ğŸ‘±ğŸ½
flag for kiribati	ğŸ‡°ğŸ‡®
regional indicator symbol letters ki	ğŸ‡°ğŸ‡®
waving hand sign	ğŸ‘‹
waving	ğŸ‘‹
goodbye	ğŸ‘‹
hand wave	ğŸ‘‹
hello	ğŸ‘‹
æŒ‡	ğŸˆ¯
finger point	ğŸˆ¯
blank	ğŸ˜
neutral face	ğŸ˜
objective	ğŸ˜
impartial	ğŸ˜
neutral	ğŸ˜
airplane arriving	ğŸ›¬
lava	ğŸŒ‹
magma	ğŸŒ‹
explode	ğŸŒ‹
hot	ğŸŒ‹
volcano	ğŸŒ‹
paperclip	ğŸ“
clippy	ğŸ“
black person with pouting face	ğŸ™ğŸ¿
black dancer	ğŸ’ƒğŸ¿
olive toned raised hand with part between middle and ring fingers	ğŸ––ğŸ½
white girl	ğŸ‘§ğŸ»
speaker with three sound waves	ğŸ”Š
increase volume	ğŸ”Š
white nose	ğŸ‘ƒğŸ»
black person frowning	ğŸ™ğŸ¿
school	ğŸ™€
painting	ğŸ™€
scream	ğŸ™€
finals	ğŸ™€
screaming cat	ğŸ™€
tiredness	ğŸ™€
exhausted	ğŸ™€
scared cat	ğŸ™€
tired	ğŸ™€
weary cat face	ğŸ™€
artist	ğŸ™€
weary	ğŸ™€
study	ğŸ™€
sleepy	ğŸ™€
black medium small square	â—¾ï¸
white small square	â–«ï¸
eight spoked asterisk	âœ³ï¸
white construction worker	ğŸ‘·ğŸ»
medium black circle	âš«
railway track	ğŸ›¤
night with stars	ğŸŒƒ
cloudless	ğŸŒƒ
city at night	ğŸŒƒ
sky	ğŸŒƒ
night	ğŸŒƒ
planets	ğŸŒƒ
star	ğŸŒƒ
space	ğŸŒƒ
starry night	ğŸŒƒ
evening	ğŸŒƒ
chipmunk	ğŸ¿
squirrel	ğŸ¿
skier	â›·
flag for taiwan	ğŸ‡¹ğŸ‡¼
flag for hong kong	ğŸ‡­ğŸ‡°
regional indicator symbol letters hk	ğŸ‡­ğŸ‡°
gem stone	ğŸ’
diamond	ğŸ’
gem	ğŸ’
hot pepper	ğŸŒ¶
chili pepper	ğŸŒ¶
spicy	ğŸŒ¶
green truck	ğŸš›
articulated	ğŸš›
articulated lorry	ğŸš›
truck	ğŸš›
lorry	ğŸš›
delivery	ğŸš›
semi	ğŸš›
cheering megaphone	ğŸ“£
megaphone	ğŸ“£
black princess	ğŸ‘¸ğŸ¿
runner	ğŸ‘Ÿ
trainer	ğŸ‘Ÿ
athletic shoe	ğŸ‘Ÿ
sneaker	ğŸ‘Ÿ
stuffed flatbread	ğŸ¥™
shawarma	ğŸ¥™
souvlaki	ğŸ¥™
doner kebab	ğŸ¥™
squared ok	ğŸ†—
okay	ğŸ†—
square	ğŸ†—
ok	ğŸ†—
spider web	ğŸ•¸
cobweb	ğŸ•¸
web	ğŸ•¸
white baby	ğŸ‘¶ğŸ»
lips	ğŸ‘„
kissing lips	ğŸ‘„
speaking	ğŸ‘„
mouth	ğŸ‘„
flag for tunisia	ğŸ‡¹ğŸ‡³
regional indicator symbol letters tn	ğŸ‡¹ğŸ‡³
medium black circle	âš«ï¸
bag	ğŸ›„
travel	ğŸ›„
baggage claim	ğŸ›„
baggage	ğŸ›„
luggage	ğŸ›„
speaker with cancellation stroke	ğŸ”‡
mute volume	ğŸ”‡
olive toned face massage	ğŸ’†ğŸ½
flag for afghanistan	ğŸ‡¦ğŸ‡«
regional indicator symbol letters af	ğŸ‡¦ğŸ‡«
afghan flag	ğŸ‡¦ğŸ‡«
page with curl	ğŸ“ƒ
curled page	ğŸ“ƒ
curly page	ğŸ“ƒ
boar	ğŸ—
wild boar	ğŸ—
wild pig	ğŸ—
olive toned mountain bicyclist	ğŸšµğŸ½
regional indicator symbol letter e	ğŸ‡ª
briefcase	ğŸ’¼
suitcase	ğŸ’¼
flag for ukraine	ğŸ‡ºğŸ‡¦
regional indicator symbol letters ua	ğŸ‡ºğŸ‡¦
cloud with rain	ğŸŒ§
mahjong tile red dragon	ğŸ€„
mahjong	ğŸ€„
mahjong tile	ğŸ€„
ä¸­	ğŸ€„
keycap digit one	1ï¸âƒ£
dollar sign	ğŸ’²
sale	ğŸ’²
dollar	ğŸ’²
money	ğŸ’²
heavy dollar sign	ğŸ’²
currency	ğŸ’²
purchase	ğŸ’²
value	ğŸ’²
cash	ğŸ’²
mosque	ğŸ•Œ
minaret	ğŸ•Œ
domed roof	ğŸ•Œ
radioactive sign	â˜¢
olive toned fisted hand sign	ğŸ‘ŠğŸ½
flag for madagascar	ğŸ‡²ğŸ‡¬
regional indicator symbol letters mg	ğŸ‡²ğŸ‡¬
black large square	â¬›ï¸
cable	ğŸš 
railway	ğŸš 
mountain cableway	ğŸš 
train	ğŸš 
mountain	ğŸš 
rail	ğŸš 
hot springs	â™¨ï¸
onsen	â™¨ï¸
steam	â™¨ï¸
heart decoration	ğŸ’Ÿ
flag for russia	ğŸ‡·ğŸ‡º
regional indicator symbol letters ru	ğŸ‡·ğŸ‡º
russian flag	ğŸ‡·ğŸ‡º
spiral bound book	ğŸ“’
ledger	ğŸ“’
yellow book	ğŸ“’
binder	ğŸ“’
regional indicator symbol letters ba	ğŸ‡§ğŸ‡¦
black person with folded hands	ğŸ™ğŸ¿
tiger	ğŸ…
hobs	ğŸ…
striped	ğŸ…
tony	ğŸ…
tigger	ğŸ…
bengal tiger	ğŸ…
cat	ğŸ…
deeper brown bath	ğŸ›€ğŸ¾
soon with rightwards arrow above	ğŸ”œ
soon	ğŸ”œ
flag for singapore	ğŸ‡¸ğŸ‡¬
regional indicator symbol letters sg	ğŸ‡¸ğŸ‡¬
couple with heart with two men	ğŸ‘¨â€â¤ï¸â€ğŸ‘¨
fishing	ğŸ£
fishing pole and fish	ğŸ£
fish	ğŸ£
fishing rod	ğŸ£
pole	ğŸ£
family of two women with one boy	ğŸ‘©â€ğŸ‘©â€ğŸ‘¦
flag for niue	ğŸ‡³ğŸ‡º
regional indicator symbol letters nu	ğŸ‡³ğŸ‡º
deeper brown baby angel	ğŸ‘¼ğŸ¾
treble clef	ğŸ¼
musical	ğŸ¼
music	ğŸ¼
score	ğŸ¼
stave	ğŸ¼
clef	ğŸ¼
sheet music	ğŸ¼
staff	ğŸ¼
musical score	ğŸ¼
flag for pitcairn islands	ğŸ‡µğŸ‡³
keycap digit nine	9ï¸âƒ£
flag for new caledonia	ğŸ‡³ğŸ‡¨
regional indicator symbol letters nc	ğŸ‡³ğŸ‡¨
new caledonian flag	ğŸ‡³ğŸ‡¨
negative squared latin capital letter p	ğŸ…¿ï¸
email	ğŸ“§
city sunset	ğŸŒ‡
city	ğŸŒ‡
scape	ğŸŒ‡
sun	ğŸŒ‡
metropolitan	ğŸŒ‡
sunrise	ğŸŒ‡
sunset over buildings	ğŸŒ‡
morning	ğŸŒ‡
light	ğŸŒ‡
dawn	ğŸŒ‡
rise	ğŸŒ‡
video tape	ğŸ“¼
vcr	ğŸ“¼
videocassette	ğŸ“¼
vhs	ğŸ“¼
flag for venezuela	ğŸ‡»ğŸ‡ª
regional indicator symbol letters ve	ğŸ‡»ğŸ‡ª
venezuelan flag	ğŸ‡»ğŸ‡ª
kiss with two men	ğŸ‘¨â€â¤ï¸â€ğŸ’‹â€ğŸ‘¨
cheese	ğŸŒ–
gibbous	ğŸŒ–
moon	ğŸŒ–
phase	ğŸŒ–
waning	ğŸŒ–
waning gibbous moon symbol	ğŸŒ–
sky	ğŸŒ–
night	ğŸŒ–
flag for georgia	ğŸ‡¬ğŸ‡ª
regional indicator symbol letters ge	ğŸ‡¬ğŸ‡ª
black waving hand sign	ğŸ‘‹ğŸ¿
flag for thailand	ğŸ‡¹ğŸ‡­
regional indicator symbol letters th	ğŸ‡¹ğŸ‡­
white rowboat	ğŸš£ğŸ»
stroll	ğŸš·
no pedestrians	ğŸš·
pedestrian	ğŸš·
walk	ğŸš·
no walking	ğŸš·
feet	ğŸš·
foot	ğŸš·
no people	ğŸš·
stride	ğŸš·
no	ğŸš·
water polo	ğŸ¤¾
loving cat	ğŸ˜»
heart eyes cat	ğŸ˜»
love	ğŸ˜»
lovestruck	ğŸ˜»
heart	ğŸ˜»
timer clock	â²
black heart suit	â™¥ï¸
hearts	â™¥ï¸
card with heart	â™¥ï¸
black universal recycling symbol	â™»ï¸
flag for guyana	ğŸ‡¬ğŸ‡¾
regional indicator symbol letters gy	ğŸ‡¬ğŸ‡¾
clutch	ğŸ‘
makeup	ğŸ‘
small bag	ğŸ‘
bag	ğŸ‘
packing	ğŸ‘
pouch	ğŸ‘
cosmetic	ğŸ‘
grandma	ğŸ‘
alembic	âš—
scared	ğŸƒ
dead	ğŸƒ
scary	ğŸƒ
carve	ğŸƒ
fall	ğŸƒ
october	ğŸƒ
horror	ğŸƒ
holiday	ğŸƒ
halloween	ğŸƒ
saints	ğŸƒ
autumn	ğŸƒ
pumpkin	ğŸƒ
spooky	ğŸƒ
costume	ğŸƒ
elderly woman	ğŸ‘µ
nanna	ğŸ‘µ
old lady	ğŸ‘µ
grandma	ğŸ‘µ
older woman	ğŸ‘µ
light brown man with gua pi mao	ğŸ‘²ğŸ¼
black older man	ğŸ‘´ğŸ¿
rolling on the floor laughing	ğŸ¤£
rofl	ğŸ¤£
flag for solomon islands	ğŸ‡¸ğŸ‡§
regional indicator symbol letters sb	ğŸ‡¸ğŸ‡§
solomon islander flag	ğŸ‡¸ğŸ‡§
sun behind cloud	â›…ï¸
motion	ğŸ¦
movie	ğŸ¦
movies	ğŸ¦
cinema	ğŸ¦
theater	ğŸ¦
picture	ğŸ¦
cinema screen	ğŸ¦
light brown face with no good gesture	ğŸ™…ğŸ¼
flag for panama	ğŸ‡µğŸ‡¦
regional indicator symbol letters pa	ğŸ‡µğŸ‡¦
black boy	ğŸ‘¦ğŸ¿
juggling	ğŸ¤¹
clock face nine oclock	ğŸ•˜
police cars revolving light	ğŸš¨
police	ğŸš¨
flashing light	ğŸš¨
emergency light	ğŸš¨
emergency	ğŸš¨
siren	ğŸš¨
police siren	ğŸš¨
light	ğŸš¨
white medium square	â—»ï¸
hibiscus	ğŸŒº
flower	ğŸŒº
warm	ğŸŒº
flag for turkey	ğŸ‡¹ğŸ‡·
regional indicator symbol letters tr	ğŸ‡¹ğŸ‡·
turkish flag	ğŸ‡¹ğŸ‡·
flag for kosovo	ğŸ‡½ğŸ‡°
kosovar flag	ğŸ‡½ğŸ‡°
thanksgiving turkey	ğŸ¦ƒ
wild turkey	ğŸ¦ƒ
roast turkey	ğŸ¦ƒ
turkey	ğŸ¦ƒ
flag for bhutan	ğŸ‡§ğŸ‡¹
regional indicator symbol letters bt	ğŸ‡§ğŸ‡¹
olive toned raised fist	âœŠğŸ½
scroll	ğŸ“œ
degree	ğŸ“œ
parchment	ğŸ“œ
dolphin	ğŸ¬
frown	ğŸ˜
disappointed face	ğŸ˜
depressed	ğŸ˜
discouraged	ğŸ˜
disappointed	ğŸ˜
sad	ğŸ˜
disappoint	ğŸ˜
sadface	ğŸ˜
flag for hungary	ğŸ‡­ğŸ‡º
regional indicator symbol letters hu	ğŸ‡­ğŸ‡º
olive toned white down pointing backhand index	ğŸ‘‡ğŸ½
flag for macedonia	ğŸ‡²ğŸ‡°
regional indicator symbol letters mk	ğŸ‡²ğŸ‡°
painting	ğŸ˜±
scream	ğŸ˜±
alien	ğŸ˜±
home alone	ğŸ˜±
screaming face	ğŸ˜±
artist	ğŸ˜±
face screaming in fear	ğŸ˜±
circled ideograph advantage	ğŸ‰
å¾—	ğŸ‰
acquire	ğŸ‰
orthodox cross	â˜¦
sashimi	ğŸ£
seafood	ğŸ£
raw	ğŸ£
fish	ğŸ£
nigiri	ğŸ£
sushi	ğŸ£
japanese	ğŸ£
large red circle	ğŸ”´
bandaged head	ğŸ¤•
injured	ğŸ¤•
clumsy	ğŸ¤•
flying money	ğŸ’¸
spend	ğŸ’¸
money with wings	ğŸ’¸
gift	ğŸ’¸
dollar	ğŸ’¸
losing money	ğŸ’¸
wings	ğŸ’¸
lost	ğŸ’¸
work	ğŸ’¸
burned	ğŸ’¸
easy	ğŸ’¸
money	ğŸ’¸
blown	ğŸ’¸
cash	ğŸ’¸
family of a man and woman with one girl and one boy	ğŸ‘¨â€ğŸ‘©â€ğŸ‘§â€ğŸ‘¦
flag for djibouti	ğŸ‡©ğŸ‡¯
regional indicator symbol letters dj	ğŸ‡©ğŸ‡¯
djibouti flag	ğŸ‡©ğŸ‡¯
djiboutian flag	ğŸ‡©ğŸ‡¯
mother	ğŸ¼
milk	ğŸ¼
bottle feeding	ğŸ¼
nipple	ğŸ¼
formula	ğŸ¼
newborn	ğŸ¼
baby	ğŸ¼
bottle	ğŸ¼
baby bottle	ğŸ¼
spit	ğŸ’§
moisture	ğŸ’§
droplet	ğŸ’§
tear	ğŸ’§
rain	ğŸ’§
drop	ğŸ’§
water	ğŸ’§
wet	ğŸ’§
sweat	ğŸ’§
moist	ğŸ’§
water drop	ğŸ’§
h20	ğŸ’§
aqua	ğŸ’§
keycap digit zero	0ï¸âƒ£
circled ideograph secret	ãŠ™ï¸
musical	ğŸµ
music	ğŸµ
music note	ğŸµ
beamed pair of quavers	ğŸµ
note	ğŸµ
sound	ğŸµ
beamed pair of eighth notes	ğŸµ
musical note	ğŸµ
badminton racquet and shuttlecock	ğŸ¸
flag for botswana	ğŸ‡§ğŸ‡¼
regional indicator symbol letters bw	ğŸ‡§ğŸ‡¼
newspaper delivery	ğŸ—
regional indicator symbol letter x	ğŸ‡½
stadium	ğŸŸ
sport stadium	ğŸŸ
grandstand	ğŸŸ
flag for syria	ğŸ‡¸ğŸ‡¾
regional indicator symbol letters sy	ğŸ‡¸ğŸ‡¾
south east arrow	â†˜ï¸
noodles with chopsticks	ğŸœ
noodles	ğŸœ
soup	ğŸœ
steaming bowl	ğŸœ
ramen	ğŸœ
steaming	ğŸœ
bowl	ğŸœ
house buildings	ğŸ˜
small orange diamond	ğŸ”¸
call me hand	ğŸ¤™
lipstick	ğŸ’„
makeup	ğŸ’„
lip gloss	ğŸ’„
system card	ğŸ“‡
card index	ğŸ“‡
index card	ğŸ“‡
rolodex	ğŸ“‡
convenience store	ğŸª
lower left paintbrush	ğŸ–Œ
light brown dancer	ğŸ’ƒğŸ¼
maiden	â™ï¸
greek	â™ï¸
stars	â™ï¸
virgo	â™ï¸
sign	â™ï¸
astrology	â™ï¸
constellation	â™ï¸
zodiac	â™ï¸
deeper brown pedestrian	ğŸš¶ğŸ¾
flag for nauru	ğŸ‡³ğŸ‡·
nauruan flag	ğŸ‡³ğŸ‡·
smoke	ğŸ‘Œ
marijuana	ğŸ‘Œ
pot	ğŸ‘Œ
okay	ğŸ‘Œ
perfect	ğŸ‘Œ
joint	ğŸ‘Œ
ok hand sign	ğŸ‘Œ
smoking	ğŸ‘Œ
ok	ğŸ‘Œ
420	ğŸ‘Œ
olive toned haircut	ğŸ’‡ğŸ½
left right arrow	â†”ï¸
tumbler glass	ğŸ¥ƒ
whisky glass	ğŸ¥ƒ
up down arrow	â†•ï¸
ambulance	ğŸš‘
help	ğŸš‘
medical	ğŸš‘
emergency	ğŸš‘
assistance	ğŸš‘
cityscape	ğŸ™
three button mouse	ğŸ–±
run	ğŸƒ
runner	ğŸƒ
sprint	ğŸƒ
race	ğŸƒ
jog	ğŸƒ
dash	ğŸƒ
jogging	ğŸƒ
exercise	ğŸƒ
black runner	ğŸƒğŸ¿
greek	â™‘
stars	â™‘
capricorn	â™‘
sign	â™‘
astrology	â™‘
constellation	â™‘
zodiac	â™‘
rightwards arrow with hook	â†ªï¸
cosmonaut	ğŸš€
spacecraft	ğŸš€
astronaut	ğŸš€
rocket ship	ğŸš€
rocket	ğŸš€
space	ğŸš€
space shuttle	ğŸš€
face throwing a kiss	ğŸ˜˜
lips	ğŸ˜˜
kissing	ğŸ˜˜
blow a kiss	ğŸ˜˜
love	ğŸ˜˜
heart	ğŸ˜˜
kiss	ğŸ˜˜
blowing kiss	ğŸ˜˜
cheese	ğŸŒš
moon	ğŸŒš
creepy moon	ğŸŒš
phase	ğŸŒš
new moon with face	ğŸŒš
sky	ğŸŒš
night	ğŸŒš
anthropomorphic	ğŸŒš
face	ğŸŒš
dark moon face	ğŸŒš
new	ğŸŒš
molester moon	ğŸŒš
clockwise downwards and upwards open circle arrows	ğŸ”ƒ
silhouette of japan	ğŸ—¾
map of japan	ğŸ—¾
guest	ğŸ‘¤
shadow	ğŸ‘¤
myself	ğŸ‘¤
avatar	ğŸ‘¤
icon	ğŸ‘¤
silhouette	ğŸ‘¤
i	ğŸ‘¤
profile	ğŸ‘¤
member	ğŸ‘¤
me	ğŸ‘¤
bust in silhouette	ğŸ‘¤
person	ğŸ‘¤
account	ğŸ‘¤
user	ğŸ‘¤
tropical	ğŸ
pina	ğŸ
flower	ğŸ
pineapple	ğŸ
white happy person raising one hand	ğŸ™‹ğŸ»
cute	ğŸ½
nose	ğŸ½
eat	ğŸ½
pig nose	ğŸ½
oink	ğŸ½
snout	ğŸ½
food	ğŸ½
smell	ğŸ½
pig snout	ğŸ½
pink	ğŸ½
truffle	ğŸ½
pig	ğŸ½
flag for chad	ğŸ‡¹ğŸ‡©
chadian flag	ğŸ‡¹ğŸ‡©
cute	ğŸ‘¿
devil	ğŸ‘¿
purple goblin	ğŸ‘¿
devil horns	ğŸ‘¿
purple devil	ğŸ‘¿
sad devil	ğŸ‘¿
imp	ğŸ‘¿
greek	â™
stars	â™
scorpius	â™
sign	â™
astrology	â™
scorpio	â™
scorpion	â™
constellation	â™
zodiac	â™
two pink hearts	ğŸ’•
two hearts	ğŸ’•
small hearts	ğŸ’•
two	ğŸ’•
emotion	ğŸ’•
hearts	ğŸ’•
love	ğŸ’•
heart	ğŸ’•
swimming	ğŸŠ
backstroke	ğŸŠ
swim	ğŸŠ
water	ğŸŠ
butterfly	ğŸŠ
laps	ğŸŠ
pool	ğŸŠ
freestyle	ğŸŠ
breaststroke	ğŸŠ
swimmer	ğŸŠ
black open hands sign	ğŸ‘ğŸ¿
flag for el salvador	ğŸ‡¸ğŸ‡»
regional indicator symbol letters sv	ğŸ‡¸ğŸ‡»
black police officer	ğŸ‘®ğŸ¿
yin yang	â˜¯
bikini	ğŸ‘™
swimsuit	ğŸ‘™
bathers	ğŸ‘™
rewind	âª
olive toned ear	ğŸ‘‚ğŸ½
airplane departure	ğŸ›«
water wave	ğŸŒŠ
tide	ğŸŒŠ
sea	ğŸŒŠ
waves	ğŸŒŠ
ocean wave	ğŸŒŠ
surf	ğŸŒŠ
ocean	ğŸŒŠ
wave	ğŸŒŠ
beach	ğŸŒŠ
fruit	ğŸ‡
grape	ğŸ‡
cluster	ğŸ‡
vinegar	ğŸ‡
wine	ğŸ‡
grapes	ğŸ‡
vine	ğŸ‡
beach with umbrella	ğŸ–
flag for cuba	ğŸ‡¨ğŸ‡º
regional indicator symbol letters cu	ğŸ‡¨ğŸ‡º
flag for falkland islands	ğŸ‡«ğŸ‡°
falklander flag	ğŸ‡«ğŸ‡°
trackball	ğŸ–²
flag for netherlands	ğŸ‡³ğŸ‡±
regional indicator symbol letters nl	ğŸ‡³ğŸ‡±
dutch flag	ğŸ‡³ğŸ‡±
flag for anguilla	ğŸ‡¦ğŸ‡®
regional indicator symbol letters ai	ğŸ‡¦ğŸ‡®
flag for tonga	ğŸ‡¹ğŸ‡´
regional indicator symbol letters to	ğŸ‡¹ğŸ‡´
flag for mongolia	ğŸ‡²ğŸ‡³
regional indicator symbol letters mn	ğŸ‡²ğŸ‡³
mongolian flag	ğŸ‡²ğŸ‡³
white older man	ğŸ‘´ğŸ»
deeper brown rowboat	ğŸš£ğŸ¾
happy face	â˜ºï¸
smiley face	â˜ºï¸
smiling	â˜ºï¸
white smiling face	â˜ºï¸
grinning face	â˜ºï¸
light brown fisted hand sign	ğŸ‘ŠğŸ¼
curly loop	â°
curling loop	â°
loop	â°
white white up pointing backhand index	ğŸ‘†ğŸ»
sparkle	â‡ï¸
bellhop bell	ğŸ›
trumpet	ğŸº
brass	ğŸº
music	ğŸº
jazz	ğŸº
horn	ğŸº
instrument	ğŸº
man in tuxedo	ğŸ¤µ
groom	ğŸ¤µ
man in suit	ğŸ¤µ
clock face five oclock	ğŸ•”
speaking head in silhouette	ğŸ—£
table tennis paddle and ball	ğŸ“
ping pong	ğŸ“
table tennis	ğŸ“
blue book	ğŸ“˜
koala	ğŸ¨
australia	ğŸ¨
drop bear	ğŸ¨
koala bear	ğŸ¨
flag for british virgin islands	ğŸ‡»ğŸ‡¬
regional indicator symbol letters vg	ğŸ‡»ğŸ‡¬
british virgin islander flag	ğŸ‡»ğŸ‡¬
mobile phone off	ğŸ“´
white large square	â¬œï¸
sand	ğŸš
spiral	ğŸš
shell	ğŸš
spiral shell	ğŸš
crab	ğŸš
nautilus	ğŸš
seashell	ğŸš
beach	ğŸš
wrench	ğŸ”§
spanner	ğŸ”§
planet	ğŸŒ
world	ğŸŒ
home	ğŸŒ
africa	ğŸŒ
globe	ğŸŒ
space	ğŸŒ
earth	ğŸŒ
europe	ğŸŒ
black face with no good gesture	ğŸ™…ğŸ¿
waving white flag	ğŸ³
baseball	âš¾ï¸
happy face	ğŸ˜Š
smile	ğŸ˜Š
smiling face with smiling eyes	ğŸ˜Š
smiley face	ğŸ˜Š
smiling	ğŸ˜Š
smiley	ğŸ˜Š
card file box	ğŸ—ƒ
red monster	ğŸ‘¹
ogre	ğŸ‘¹
mask	ğŸ‘¹
monster	ğŸ‘¹
scary face	ğŸ‘¹
scary	ğŸ‘¹
japanese ogre	ğŸ‘¹
folklore	ğŸ‘¹
devil	ğŸ‘¹
teeth	ğŸ‘¹
demon	ğŸ‘¹
theater	ğŸ‘¹
oni	ğŸ‘¹
horns	ğŸ‘¹
troll	ğŸ‘¹
japanese	ğŸ‘¹
tokyo tower	ğŸ—¼
red tower	ğŸ—¼
eiffel tower	ğŸ—¼
disappointed but relieved face	ğŸ˜¥
eyebrow sweat	ğŸ˜¥
disappoint	ğŸ˜¥
relief	ğŸ˜¥
show	ğŸ«
admission	ğŸ«
ticket	ğŸ«
entertainment	ğŸ«
ticket stub	ğŸ«
world tour ticket	ğŸ«
proof	ğŸ«
purchase	ğŸ«
stub	ğŸ«
comet	â˜„
light beam	â˜„
blue beam	â˜„
flag for tuvalu	ğŸ‡¹ğŸ‡»
regional indicator symbol letters tv	ğŸ‡¹ğŸ‡»
numeric input	ğŸ”¢
input symbol for numbers	ğŸ”¢
numbers	ğŸ”¢
1234	ğŸ”¢
banknote	ğŸ’´
yen note	ğŸ’´
bill	ğŸ’´
paper	ğŸ’´
money	ğŸ’´
currency	ğŸ’´
japan	ğŸ’´
banknote with yen sign	ğŸ’´
japanese	ğŸ’´
yen	ğŸ’´
cash	ğŸ’´
raised hand	âœ‹
high five	âœ‹
stop	âœ‹
deeper brown white up pointing backhand index	ğŸ‘†ğŸ¾
star and crescent	â˜ª
registered sign	Â®ï¸
flag in hole	â›³ï¸
litter	ğŸš®
garbage	ğŸš®
put litter in trash	ğŸš®
can	ğŸš®
put litter in its place symbol	ğŸš®
receptacle	ğŸš®
person with trash	ğŸš®
waste	ğŸš®
trash	ğŸš®
barber shop	ğŸ’ˆ
barber pole	ğŸ’ˆ
hairdresser	ğŸ’ˆ
barbers stripes	ğŸ’ˆ
crab	ğŸ¦€
crab cancer	ğŸ¦€
red crab	ğŸ¦€
black small square	â–ªï¸
olive toned boy	ğŸ‘¦ğŸ½
cow face	ğŸ®
cow	ğŸ®
happy cow	ğŸ®
flag for mexico	ğŸ‡²ğŸ‡½
regional indicator symbol letters mx	ğŸ‡²ğŸ‡½
mexican flag	ğŸ‡²ğŸ‡½
leaves	ğŸƒ
leaf fluttering in wind	ğŸƒ
float	ğŸƒ
fluttering	ğŸƒ
spring	ğŸƒ
wind	ğŸƒ
green leaves	ğŸƒ
leaf	ğŸƒ
hit	ğŸ¯
archery	ğŸ¯
dart	ğŸ¯
bullseye	ğŸ¯
direct hit	ğŸ¯
direct	ğŸ¯
sport	ğŸ¯
fletching	ğŸ¯
game	ğŸ¯
arrow	ğŸ¯
squared vs	ğŸ†š
hamster face	ğŸ¹
hamster	ğŸ¹
å–¶	ğŸˆº
work	ğŸˆº
tongue face	ğŸ˜›
cheeky	ğŸ˜›
silly	ğŸ˜›
tongue	ğŸ˜›
playful	ğŸ˜›
hourglass	âŒ›
bow and arrow	ğŸ¹
archery	ğŸ¹
circled latin capital letter m	â“‚ï¸
flag for burundi	ğŸ‡§ğŸ‡®
regional indicator symbol letters bi	ğŸ‡§ğŸ‡®
deeper brown person with blond hair	ğŸ‘±ğŸ¾
circled ideograph accept	ğŸ‰‘
gasping face	ğŸ˜²
astonished face	ğŸ˜²
shocked	ğŸ˜²
surprise	ğŸ˜²
astonished	ğŸ˜²
shocked face	ğŸ˜²
drunk face	ğŸ˜²
slop	ğŸ–
pork	ğŸ–
greed	ğŸ–
ham	ğŸ–
oink	ğŸ–
greedy	ğŸ–
sow	ğŸ–
bacon	ğŸ–
livestock	ğŸ–
hog	ğŸ–
piggy	ğŸ–
pig	ğŸ–
white left pointing backhand index	ğŸ‘ˆ
pointing left	ğŸ‘ˆ
leftwards black arrow	â¬…ï¸
spiral note pad	ğŸ—’
regional indicator symbol letter l	ğŸ‡±
crossed swords	âš”
skull and crossbones	â˜ 
envelope	âœ‰ï¸
deeper brown raised hand with part between middle and ring fingers	ğŸ––ğŸ¾
festival	ğŸ‹
wish tree	ğŸ‹
tanabata tree	ğŸ‹
tanabata	ğŸ‹
star	ğŸ‹
holiday	ğŸ‹
tree	ğŸ‹
wish	ğŸ‹
wink	ğŸ˜œ
crazy face	ğŸ˜œ
crazy	ğŸ˜œ
silly	ğŸ˜œ
tongue	ğŸ˜œ
playful	ğŸ˜œ
kidding	ğŸ˜œ
winking	ğŸ˜œ
level slider	ğŸš
black raised hand	âœ‹ğŸ¿
clockwise rightwards and leftwards open circle arrows with circled one overlay	ğŸ”‚
loop once symbol	ğŸ”‚
circle arrows with number 1	ğŸ”‚
flag for india	ğŸ‡®ğŸ‡³
regional indicator symbol letters in	ğŸ‡®ğŸ‡³
indian flag	ğŸ‡®ğŸ‡³
snow cone	ğŸ§
shaved	ğŸ§
shaved ice	ğŸ§
dessert	ğŸ§
flavoring	ğŸ§
ice	ğŸ§
syrup	ğŸ§
treat	ğŸ§
regional indicator symbol letters lc	ğŸ‡±ğŸ‡¨
keycap digit five	5ï¸âƒ£
wastebasket	ğŸ—‘
notifications enabled	ğŸ””
ringer	ğŸ””
bell	ğŸ””
wedding bell	ğŸ””
hot dog	ğŸŒ­
hotdog	ğŸŒ­
sausage	ğŸŒ­
flag for suriname	ğŸ‡¸ğŸ‡·
regional indicator symbol letters sr	ğŸ‡¸ğŸ‡·
oregon	ğŸº
malt	ğŸº
yeast	ğŸº
portland	ğŸº
boot	ğŸº
beer mug	ğŸº
barley	ğŸº
brewery	ğŸº
beer stein	ğŸº
lager	ğŸº
pint	ğŸº
beer	ğŸº
mug	ğŸº
micro	ğŸº
hops	ğŸº
fire	ğŸš’
fire engine	ğŸš’
fire department	ğŸš’
truck	ğŸš’
fire truck	ğŸš’
fighter	ğŸš’
medical	ğŸš’
emergency	ğŸš’
engine	ğŸš’
steamed rice	ğŸš
rice	ğŸš
food	ğŸš
grain	ğŸš
cooked rice	ğŸš
boiled rice	ğŸš
bowl	ğŸš
white	ğŸš
bowl of rice	ğŸš
blue	ğŸ’™
trust	ğŸ’™
loyalty	ğŸ’™
blue heart	ğŸ’™
love	ğŸ’™
heart	ğŸ’™
stability	ğŸ’™
truth	ğŸ’™
down	ğŸ‘
thumb	ğŸ‘
hand	ğŸ‘
dislike	ğŸ‘
gesture	ğŸ‘
boo	ğŸ‘
stop	ğŸ‘
disapproval	ğŸ‘
sign	ğŸ‘
thumbs down sign	ğŸ‘
thumbs down	ğŸ‘
no	ğŸ‘
man	ğŸ‘¨
male	ğŸ‘¨
moustache man	ğŸ‘¨
metro	ğŸš‡
underground	ğŸš‡
subway	ğŸš‡
train	ğŸš‡
lemonade	ğŸ‹
yellow fruit	ğŸ‹
yellow	ğŸ‹
citrus	ğŸ‹
lemon	ğŸ‹
caterpillar	ğŸ›
virus	ğŸ›
error	ğŸ›
bug	ğŸ›
insect	ğŸ›
centipede	ğŸ›
vapid	ğŸ˜‘
void	ğŸ˜‘
without expression	ğŸ˜‘
blank	ğŸ˜‘
expressionless	ğŸ˜‘
robot face	ğŸ˜‘
face with straight mouth	ğŸ˜‘
expressionless face	ğŸ˜‘
court	ğŸ¾
tennis	ğŸ¾
tennis racquet and ball	ğŸ¾
racquet	ğŸ¾
net	ğŸ¾
tennis racket	ğŸ¾
love	ğŸ¾
ball	ğŸ¾
tennis ball	ğŸ¾
tennis racquet	ğŸ¾
racket	ğŸ¾
game	ğŸ¾
sexy	ğŸ™
cute	ğŸ™
person with pouting face	ğŸ™
blank look	ğŸ™
fed up	ğŸ™
pout	ğŸ™
annoyed	ğŸ™
heavy division sign	â—
flag for cyprus	ğŸ‡¨ğŸ‡¾
regional indicator symbol letters cy	ğŸ‡¨ğŸ‡¾
flag for nepal	ğŸ‡³ğŸ‡µ
regional indicator symbol letters np	ğŸ‡³ğŸ‡µ
white bath	ğŸ›€ğŸ»
flag for haiti	ğŸ‡­ğŸ‡¹
regional indicator symbol letters ht	ğŸ‡­ğŸ‡¹
haitian flag	ğŸ‡­ğŸ‡¹
deeper brown face with ok gesture	ğŸ™†ğŸ¾
drive	ğŸ’¾
floppy	ğŸ’¾
disk	ğŸ’¾
information	ğŸ’¾
megabyte	ğŸ’¾
computer	ğŸ’¾
floppy disk	ğŸ’¾
storage	ğŸ’¾
laughing	ğŸ˜†
laugh	ğŸ˜†
smiling	ğŸ˜†
big grin	ğŸ˜†
buds	ğŸ§
music	ğŸ§
audio	ğŸ§
listen	ğŸ§
sound	ğŸ§
beats	ğŸ§
ears	ğŸ§
headphone	ğŸ§
rodent	ğŸ
dormouse	ğŸ
mice	ğŸ
mouse	ğŸ
flag for belize	ğŸ‡§ğŸ‡¿
regional indicator symbol letters bz	ğŸ‡§ğŸ‡¿
light brown father christmas	ğŸ…ğŸ¼
greek	â™Š
stars	â™Š
sign	â™Š
twins	â™Š
astrology	â™Š
gemini	â™Š
constellation	â™Š
zodiac	â™Š
flag for grenada	ğŸ‡¬ğŸ‡©
regional indicator symbol letters gd	ğŸ‡¬ğŸ‡©
alien	ğŸ‘½
extraterrestrial alien	ğŸ‘½
et	ğŸ‘½
ufo	ğŸ‘½
bookmark tabs	ğŸ“‘
compression	ğŸ—œ
regional indicator symbol letter v	ğŸ‡»
snow	â„ï¸
chilly	â„ï¸
winter	â„ï¸
droplet	â„ï¸
elsa	â„ï¸
below zero	â„ï¸
crystal	â„ï¸
cold	â„ï¸
frozen	â„ï¸
ice	â„ï¸
snowing	â„ï¸
special	â„ï¸
unique	â„ï¸
snowflake	â„ï¸
lower left ballpoint pen	ğŸ–Š
office building	ğŸ¢
city building	ğŸ¢
flag for diego garcia	ğŸ‡©ğŸ‡¬
deeper brown person with pouting face	ğŸ™ğŸ¾
horse racing	ğŸ‡
horse race	ğŸ‡
jockey	ğŸ‡
horse	ğŸ‡
race	ğŸ‡
racing	ğŸ‡
triple crown	ğŸ‡
flag for chile	ğŸ‡¨ğŸ‡±
regional indicator symbol letters cl	ğŸ‡¨ğŸ‡±
anger sign	ğŸ’¢
anger symbol	ğŸ’¢
anger	ğŸ’¢
punch	ğŸ’¢
greek	â›
stars	â›
ophiuchus	â›
serpent	â›
snake	â›
astrology	â›
constellation	â›
zodiac	â›
squared free	ğŸ†“
free	ğŸ†“
man in business suit levitating	ğŸ•´
walt jabsco	ğŸ•´
hovering man	ğŸ•´
carrot	ğŸ¥•
sheep	ğŸ
billy goat	ğŸ
goat	ğŸ
billy	ğŸ
livestock	ğŸ
kid	ğŸ
right fist bump	ğŸ¤œ
black white down pointing backhand index	ğŸ‘‡ğŸ¿
notebook with decorative cover	ğŸ“”
police	ğŸ‘®
policewoman	ğŸ‘®
police officer	ğŸ‘®
cop	ğŸ‘®
policeman	ğŸ‘®
puffer	ğŸ¡
fugu fish	ğŸ¡
toadfish	ğŸ¡
pufferfish	ğŸ¡
tetraodontidae	ğŸ¡
ballonfish	ğŸ¡
sushi	ğŸ¡
fugu	ğŸ¡
blowfish	ğŸ¡
white bicyclist	ğŸš´ğŸ»
flag for mauritius	ğŸ‡²ğŸ‡º
flag for lebanon	ğŸ‡±ğŸ‡§
regional indicator symbol letters lb	ğŸ‡±ğŸ‡§
horse face	ğŸ´
horse head	ğŸ´
regional indicator symbol letter q	ğŸ‡¶
deeper brown older woman	ğŸ‘µğŸ¾
linked paperclips	ğŸ–‡
keycap digit nine	9âƒ£ï¸
light brown princess	ğŸ‘¸ğŸ¼
hearing	ğŸ‘‚
ear	ğŸ‘‚
listening	ğŸ‘‚
ears	ğŸ‘‚
deeper brown woman	ğŸ‘©ğŸ¾
light brown baby angel	ğŸ‘¼ğŸ¼
no entry	â›”
deeper brown nail polish	ğŸ’…ğŸ¾
no one under eighteen symbol	ğŸ”
trade mark sign	â„¢ï¸
clock face twelve oclock	ğŸ•›
flag for ecuador	ğŸ‡ªğŸ‡¨
regional indicator symbol letters ec	ğŸ‡ªğŸ‡¨
ecuadorian flag	ğŸ‡ªğŸ‡¨
white person with folded hands	ğŸ™ğŸ»
telephone receiver	ğŸ“
phone	ğŸ“
handset	ğŸ“
heart envelope	ğŸ’Œ
letter	ğŸ’Œ
love note	ğŸ’Œ
love	ğŸ’Œ
heart	ğŸ’Œ
kiss	ğŸ’Œ
love letter	ğŸ’Œ
deeper brown guardsman	ğŸ’‚ğŸ¾
flag for bolivia	ğŸ‡§ğŸ‡´
regional indicator symbol letters bo	ğŸ‡§ğŸ‡´
bolivian flag	ğŸ‡§ğŸ‡´
white thumbs up sign	ğŸ‘ğŸ»
light brown bride with veil	ğŸ‘°ğŸ¼
painting	ğŸ–¼
frame with picture	ğŸ–¼
gallery	ğŸ–¼
picture frame	ğŸ–¼
æœ‰	ğŸˆ¶
own	ğŸˆ¶
lips	ğŸ˜—
duck face	ğŸ˜—
kissing	ğŸ˜—
kissy face	ğŸ˜—
smooch	ğŸ˜—
kissing face	ğŸ˜—
whistling	ğŸ˜—
pucker	ğŸ˜—
kiss	ğŸ˜—
sake	ğŸ¶
sake bottle and cup	ğŸ¶
ferment	ğŸ¶
drink	ğŸ¶
rice	ğŸ¶
wine	ğŸ¶
alcohol	ğŸ¶
japanese	ğŸ¶
bottle	ğŸ¶
rice wine	ğŸ¶
ferry	â›´
flag for belgium	ğŸ‡§ğŸ‡ª
regional indicator symbol letters be	ğŸ‡§ğŸ‡ª
womans boots	ğŸ‘¢
knee high boots	ğŸ‘¢
cowgirl boots	ğŸ‘¢
unity	ğŸ‘¬
hands	ğŸ‘¬
boys holding hands	ğŸ‘¬
gay men	ğŸ‘¬
homosexual	ğŸ‘¬
gay couple	ğŸ‘¬
men	ğŸ‘¬
friends	ğŸ‘¬
team	ğŸ‘¬
gay	ğŸ‘¬
two men holding hands	ğŸ‘¬
holding	ğŸ‘¬
radio button	ğŸ”˜
avatar	ğŸšº
female	ğŸšº
womens toilet	ğŸšº
bathroom	ğŸšº
sign	ğŸšº
woman	ğŸšº
girl	ğŸšº
female restroom	ğŸšº
womens symbol	ğŸšº
restroom	ğŸšº
church	â›ª
church building	â›ª
cross	â›ª
jaw	ğŸ˜®
open mouth	ğŸ˜®
open	ğŸ˜®
gapping	ğŸ˜®
face with open mouth	ğŸ˜®
mouth	ğŸ˜®
flag for eritrea	ğŸ‡ªğŸ‡·
regional indicator symbol letters er	ğŸ‡ªğŸ‡·
white thumbs down sign	ğŸ‘ğŸ»
bearskin	ğŸ’‚
ceremonial	ğŸ’‚
guardsman	ğŸ’‚
queen	ğŸ’‚
hat	ğŸ’‚
british	ğŸ’‚
guard	ğŸ’‚
military	ğŸ’‚
british guardsman	ğŸ’‚
foot guard	ğŸ’‚
family of two men with one girl	ğŸ‘¨â€ğŸ‘¨â€ğŸ‘§
camera with flash	ğŸ“¸
smiling face with open mouth	ğŸ˜ƒ
happy face	ğŸ˜ƒ
smile	ğŸ˜ƒ
happy	ğŸ˜ƒ
smiley face	ğŸ˜ƒ
smiling	ğŸ˜ƒ
smiley	ğŸ˜ƒ
grinning face	ğŸ˜ƒ
olive toned surfer	ğŸ„ğŸ½
regional indicator symbol letters gw	ğŸ‡¬ğŸ‡¼
currency exchange	ğŸ’±
firework sparkler	ğŸ‡
payday	ğŸ§
automated teller machine	ğŸ§
bank	ğŸ§
adam	ğŸ§
money	ğŸ§
financial	ğŸ§
withdrawal	ğŸ§
deposit	ğŸ§
atm	ğŸ§
cash	ğŸ§
black white left pointing backhand index	ğŸ‘ˆğŸ¿
dove of peace	ğŸ•Š
regional indicator symbol letters tl	ğŸ‡¹ğŸ‡±
flag for senegal	ğŸ‡¸ğŸ‡³
regional indicator symbol letters sn	ğŸ‡¸ğŸ‡³
deeper brown swimmer	ğŸŠğŸ¾
candy	ğŸ«
chocolate	ğŸ«
chocolate bar	ğŸ«
block of chocolate	ğŸ«
bar	ğŸ«
coca	ğŸ«
couch and lamp	ğŸ›‹
couch	ğŸ›‹
lounge	ğŸ›‹
hocho	ğŸ”ª
butchers knife	ğŸ”ª
kitchen knife	ğŸ”ª
knife	ğŸ”ª
film frames	ğŸ
flag for uzbekistan	ğŸ‡ºğŸ‡¿
regional indicator symbol letters uz	ğŸ‡ºğŸ‡¿
flag for jordan	ğŸ‡¯ğŸ‡´
regional indicator symbol letters jo	ğŸ‡¯ğŸ‡´
png flag	ğŸ‡µğŸ‡¬
regional indicator symbol letters pg	ğŸ‡µğŸ‡¬
flag for papua new guinea	ğŸ‡µğŸ‡¬
papua new guinean flag	ğŸ‡µğŸ‡¬
banned	ğŸš«
entry	ğŸš«
no entry sign	ğŸš«
stop	ğŸš«
restriction	ğŸš«
red circle crossed	ğŸš«
no	ğŸš«
taxicab	ğŸš–
city	ğŸš–
car	ğŸš–
service	ğŸš–
oncoming taxi	ğŸš–
automobile	ğŸš–
transport	ğŸš–
taxi	ğŸš–
front of taxi	ğŸš–
gift box	ğŸ’
chocolate box	ğŸ’
heart with ribbon	ğŸ’
gift heart	ğŸ’
bat	ğŸ¦‡
black bat	ğŸ¦‡
batman	ğŸ¦‡
barbecue	ğŸ–
meat on bone	ğŸ–
bbq	ğŸ–
cooked	ğŸ–
meat	ğŸ–
manga meat	ğŸ–
bone	ğŸ–
animal	ğŸ–
ano niku	ğŸ–
flag for faroe islands	ğŸ‡«ğŸ‡´
regional indicator symbol letters fo	ğŸ‡«ğŸ‡´
faroe islander flag	ğŸ‡«ğŸ‡´
flag for samoa	ğŸ‡¼ğŸ‡¸
regional indicator symbol letters ws	ğŸ‡¼ğŸ‡¸
flag for cook islands	ğŸ‡¨ğŸ‡°
regional indicator symbol letters ck	ğŸ‡¨ğŸ‡°
snow	ğŸ‚
snowboarding	ğŸ‚
winter	ğŸ‚
snowboarder	ğŸ‚
boarding	ğŸ‚
snowboard	ğŸ‚
sports	ğŸ‚
board	ğŸ‚
alpine	ğŸ‚
freestyle	ğŸ‚
mountain	ğŸ‚
halfpipe	ğŸ‚
flag for kazakhstan	ğŸ‡°ğŸ‡¿
regional indicator symbol letters kz	ğŸ‡°ğŸ‡¿
deeper brown person raising both hands in celebration	ğŸ™ŒğŸ¾
popcorn	ğŸ¿
popping corn	ğŸ¿
film projector	ğŸ“½
locomotive	ğŸš‹
train	ğŸš‹
tram car	ğŸš‹
rail	ğŸš‹
hot beverage	â˜•ï¸
olive toned man with turban	ğŸ‘³ğŸ½
flag for jersey	ğŸ‡¯ğŸ‡ª
deeper brown face with no good gesture	ğŸ™…ğŸ¾
young	ğŸ‘±
blond man	ğŸ‘±
occidental	ğŸ‘±
person with blond hair	ğŸ‘±
westerner	ğŸ‘±
blonde	ğŸ‘±
western	ğŸ‘±
blond	ğŸ‘±
cheese	ğŸŒ•
moon	ğŸŒ•
monster	ğŸŒ•
phase	ğŸŒ•
full	ğŸŒ•
sky	ğŸŒ•
night	ğŸŒ•
twilight	ğŸŒ•
werewolves	ğŸŒ•
full moon symbol	ğŸŒ•
spooky	ğŸŒ•
white sun behind cloud with rain	ğŸŒ¦
flag for canada	ğŸ‡¨ğŸ‡¦
regional indicator symbol letters ca	ğŸ‡¨ğŸ‡¦
open file folder	ğŸ“‚
open folder	ğŸ“‚
light brown thumbs down sign	ğŸ‘ğŸ¼
seafood	ğŸ¢
skewer	ğŸ¢
stew	ğŸ¢
oden	ğŸ¢
kebab	ğŸ¢
casserole	ğŸ¢
black large square	â¬›
deeper brown happy person raising one hand	ğŸ™‹ğŸ¾
greek	â™
stars	â™
sign	â™
libra	â™
scales	â™
astrology	â™
constellation	â™
zodiac	â™
flag for togo	ğŸ‡¹ğŸ‡¬
regional indicator symbol letters tg	ğŸ‡¹ğŸ‡¬
pencil and paper	ğŸ“
memorandum	ğŸ“
note	ğŸ“
memo	ğŸ“
weight lifter	ğŸ‹
weightlifting	ğŸ‹
communication	ğŸ’¬
conversation	ğŸ’¬
speech bubble	ğŸ’¬
talk	ğŸ’¬
dialogue	ğŸ’¬
comic	ğŸ’¬
chat bubble	ğŸ’¬
balloon	ğŸ’¬
speech	ğŸ’¬
speech balloon	ğŸ’¬
olive toned princess	ğŸ‘¸ğŸ½
crown	ğŸ‘‘
queen	ğŸ‘‘
king	ğŸ‘‘
royal	ğŸ‘‘
helmet with white cross	â›‘
dress	ğŸ’ƒ
fancy	ğŸ’ƒ
ballet	ğŸ’ƒ
music	ğŸ’ƒ
boogy	ğŸ’ƒ
dancer	ğŸ’ƒ
salsa dancer	ğŸ’ƒ
red dress woman	ğŸ’ƒ
party	ğŸ’ƒ
dance	ğŸ’ƒ
dancing	ğŸ’ƒ
tango	ğŸ’ƒ
cha cha	ğŸ’ƒ
celebrate	ğŸ’ƒ
white nail polish	ğŸ’…ğŸ»
wilted flower	ğŸ¥€
dead flower	ğŸ¥€
drooping flower	ğŸ¥€
tie	ğŸ‘”
necktie	ğŸ‘”
shirt and tie	ğŸ‘”
business shirt	ğŸ‘”
revolving	ğŸ’
two hearts	ğŸ’
circle	ğŸ’
lovers	ğŸ’
moving	ğŸ’
hearts	ğŸ’
multiple	ğŸ’
heart	ğŸ’
revolving hearts	ğŸ’
national park	ğŸ
squared cl	ğŸ†‘
clear	ğŸ†‘
clear button	ğŸ†‘
bacon	ğŸ¥“
crying	ğŸ˜¢
tear	ğŸ˜¢
weep	ğŸ˜¢
crying face	ğŸ˜¢
sad	ğŸ˜¢
cry	ğŸ˜¢
flag for iraq	ğŸ‡®ğŸ‡¶
regional indicator symbol letters iq	ğŸ‡®ğŸ‡¶
iraqi flag	ğŸ‡®ğŸ‡¶
bullet	ğŸš„
train	ğŸš„
rail	ğŸš„
regional indicator symbol letter u	ğŸ‡º
light brown information desk person	ğŸ’ğŸ¼
face with cowboy hat	ğŸ¤ 
cowboy	ğŸ¤ 
black bath	ğŸ›€ğŸ¿
flag for azerbaijan	ğŸ‡¦ğŸ‡¿
regional indicator symbol letters az	ğŸ‡¦ğŸ‡¿
azerbaijani flag	ğŸ‡¦ğŸ‡¿
family of two women with one girl	ğŸ‘©â€ğŸ‘©â€ğŸ‘§
desert	ğŸŒµ
poke	ğŸŒµ
drought	ğŸŒµ
wild west	ğŸŒµ
spike	ğŸŒµ
cactus	ğŸŒµ
heavy multiplication x	âœ–ï¸
psychic	ğŸ”®
clairvoyant	ğŸ”®
gypsy	ğŸ”®
shew stone	ğŸ”®
fortune teller	ğŸ”®
purple crystal	ğŸ”®
crystal ball	ğŸ”®
ice skate	â›¸
idaho	ğŸŸ
fry	ğŸŸ
french	ğŸŸ
potato	ğŸŸ
russet	ğŸŸ
fries	ğŸŸ
french fries	ğŸŸ
mcdonalds fries	ğŸŸ
light brown white up pointing backhand index	ğŸ‘†ğŸ¼
light brown haircut	ğŸ’‡ğŸ¼
planet	ğŸŒ
meridian	ğŸŒ
home	ğŸŒ
globe	ğŸŒ
space	ğŸŒ
world wide web	ğŸŒ
globe with meridians	ğŸŒ
earth	ğŸŒ
www	ğŸŒ
flag for bahamas	ğŸ‡§ğŸ‡¸
regional indicator symbol letters bs	ğŸ‡§ğŸ‡¸
public address loudspeaker	ğŸ“¢
pa system	ğŸ“¢
announcement	ğŸ“¢
olive toned horse racing	ğŸ‡ğŸ½
light brown woman	ğŸ‘©ğŸ¼
flag for indonesia	ğŸ‡®ğŸ‡©
regional indicator symbol letters id	ğŸ‡®ğŸ‡©
deeper brown white left pointing backhand index	ğŸ‘ˆğŸ¾
white swimmer	ğŸŠğŸ»
up triangle	ğŸ”¼
handshake	ğŸ¤
shaking hands	ğŸ¤
ac adaptor	ğŸ”Œ
power plug	ğŸ”Œ
electric plug	ğŸ”Œ
power cable	ğŸ”Œ
candles	ğŸ•
chanukiah	ğŸ•
menorah with nine branches	ğŸ•
candelabrum	ğŸ•
menorah	ğŸ•
light brown face massage	ğŸ’†ğŸ¼
flag for vanuatu	ğŸ‡»ğŸ‡º
regional indicator symbol letters vu	ğŸ‡»ğŸ‡º
flag for egypt	ğŸ‡ªğŸ‡¬
regional indicator symbol letters eg	ğŸ‡ªğŸ‡¬
egyptian flag	ğŸ‡ªğŸ‡¬
deeper brown bicyclist	ğŸš´ğŸ¾
alien monster	ğŸ‘¾
space invader	ğŸ‘¾
video game monster	ğŸ‘¾
footprints	ğŸ‘£
feet	ğŸ‘£
footsteps	ğŸ‘£
australian flag	ğŸ‡¦ğŸ‡º
regional indicator symbol letters au	ğŸ‡¦ğŸ‡º
aussie flag	ğŸ‡¦ğŸ‡º
flag for australia	ğŸ‡¦ğŸ‡º
deeper brown open hands sign	ğŸ‘ğŸ¾
human rock carving	ğŸ—¿
moai	ğŸ—¿
moyai	ğŸ—¿
easter island	ğŸ—¿
moyai statue	ğŸ—¿
flag for north korea	ğŸ‡°ğŸ‡µ
regional indicator symbol letters kp	ğŸ‡°ğŸ‡µ
minidisc	ğŸ’½
eight pointed black star	âœ´ï¸
orange star	âœ´ï¸
walker	ğŸš¶
stroll	ğŸš¶
pedestrian	ğŸš¶
walk	ğŸš¶
feet	ğŸš¶
walking	ğŸš¶
foot	ğŸš¶
stride	ğŸš¶
nut	ğŸŒ°
chestnut	ğŸŒ°
food	ğŸŒ°
roasted	ğŸŒ°
tree	ğŸŒ°
acorn	ğŸŒ°
smiling cat	ğŸ˜º
smile	ğŸ˜º
happy	ğŸ˜º
happy cat	ğŸ˜º
smiling cat face with open mouth	ğŸ˜º
smiley	ğŸ˜º
cat	ğŸ˜º
flag for clipperton island	ğŸ‡¨ğŸ‡µ
white runner	ğŸƒğŸ»
tassel	ğŸ“
ceremony	ğŸ“
graduation cap	ğŸ“
square	ğŸ“
education	ğŸ“
academic	ğŸ“
mortarboard	ğŸ“
cap	ğŸ“
graduation	ğŸ“
hammer and pick	âš’
kitty	ğŸ±
kitten	ğŸ±
cat face	ğŸ±
white father christmas	ğŸ…ğŸ»
birthday	ğŸ‚
cake with candles	ğŸ‚
birth	ğŸ‚
dessert	ğŸ‚
cake	ğŸ‚
birthday cake	ğŸ‚
celebrate	ğŸ‚
wish	ğŸ‚
deeper brown nose	ğŸ‘ƒğŸ¾
shamrock	â˜˜
black white right pointing backhand index	ğŸ‘‰ğŸ¿
lion	â™Œï¸
greek	â™Œï¸
stars	â™Œï¸
sign	â™Œï¸
leo	â™Œï¸
astrology	â™Œï¸
constellation	â™Œï¸
zodiac	â™Œï¸
school	ğŸ«
high school	ğŸ«
clock tower	ğŸ«
teach	ğŸ«
elementary school	ğŸ«
middle	ğŸ«
education	ğŸ«
university	ğŸ«
middle school	ğŸ«
elementary	ğŸ«
college	ğŸ«
high	ğŸ«
flag for rÃ©union	ğŸ‡·ğŸ‡ª
regional indicator symbol letters re	ğŸ‡·ğŸ‡ª
rÃ©unionnais flag	ğŸ‡·ğŸ‡ª
hand	ğŸ™‹
happy person raising one hand	ğŸ™‹
attention	ğŸ™‹
hand up	ğŸ™‹
raise	ğŸ™‹
answering question	ğŸ™‹
notice	ğŸ™‹
answer	ğŸ™‹
white white left pointing backhand index	ğŸ‘ˆğŸ»
unity	ğŸ‘­
mother	ğŸ‘­
women	ğŸ‘­
daughter	ğŸ‘­
hands	ğŸ‘­
homosexual	ğŸ‘­
lesbian couple	ğŸ‘­
lesbian	ğŸ‘­
sisters	ğŸ‘­
girls holding hands	ğŸ‘­
friends	ğŸ‘­
girlfriends	ğŸ‘­
couple	ğŸ‘­
gay	ğŸ‘­
two women holding hands	ğŸ‘­
atom symbol	âš›
tired face	ğŸ˜«
exhausted	ğŸ˜«
tired	ğŸ˜«
fed up	ğŸ˜«
sleepy	ğŸ˜«
flag for comoros	ğŸ‡°ğŸ‡²
regional indicator symbol letters km	ğŸ‡°ğŸ‡²
laughing	ğŸ˜‚
lol	ğŸ˜‚
laughing crying	ğŸ˜‚
tears	ğŸ˜‚
joy	ğŸ˜‚
happy	ğŸ˜‚
laughing tears	ğŸ˜‚
cry	ğŸ˜‚
face with tears of joy	ğŸ˜‚
light brown surfer	ğŸ„ğŸ¼
fair	ğŸ¢
theme park	ğŸ¢
roller	ğŸ¢
roller coaster	ğŸ¢
amusement	ğŸ¢
rollercoaster	ğŸ¢
entertainment	ğŸ¢
park	ğŸ¢
ride	ğŸ¢
coaster	ğŸ¢
top with upwards arrow above	ğŸ”
top	ğŸ”
keycap digit six	6ï¸âƒ£
white face with no good gesture	ğŸ™…ğŸ»
ç©º	ğŸˆ³
empty and available	ğŸˆ³
serious	ğŸ˜”
thoughtful	ğŸ˜”
think	ğŸ˜”
meditate	ğŸ˜”
wistful	ğŸ˜”
pensive face	ğŸ˜”
sad	ğŸ˜”
pensive	ğŸ˜”
sadface	ğŸ˜”
sorrowful	ğŸ˜”
reflective	ğŸ˜”
butterfly	ğŸ¦‹
light brown construction worker	ğŸ‘·ğŸ¼
package	ğŸšš
truck	ğŸšš
delivery	ğŸšš
delivery truck	ğŸšš
open mailbox with raised flag	ğŸ“¬
open mailbox	ğŸ“¬
couple with heart	ğŸ’‘
loving couple	ğŸ’‘
couple in love	ğŸ’‘
flag for central african republic	ğŸ‡¨ğŸ‡«
regional indicator symbol letters cf	ğŸ‡¨ğŸ‡«
flag for palestinian territories	ğŸ‡µğŸ‡¸
regional indicator symbol letters ps	ğŸ‡µğŸ‡¸
black and yellow striped sign	ğŸš§
construction sign	ğŸš§
roadwork sign	ğŸš§
roadwork	ğŸš§
flag for lithuania	ğŸ‡±ğŸ‡¹
regional indicator symbol letters lt	ğŸ‡±ğŸ‡¹
lithuanian flag	ğŸ‡±ğŸ‡¹
derelict house building	ğŸš
old house	ğŸš
abandoned house	ğŸš
orange book	ğŸ“™
black girl	ğŸ‘§ğŸ¿
deeper brown raised fist	âœŠğŸ¾
key	ğŸ”‘
mobile phone	ğŸ“±
cell phone	ğŸ“±
smartphone	ğŸ“±
iphone	ğŸ“±
android	ğŸ“±
lights	ğŸŒ†
dusk city	ğŸŒ†
city	ğŸŒ†
cityscape at dusk	ğŸŒ†
scape	ğŸŒ†
night	ğŸŒ†
dusk	ğŸŒ†
metropolitan	ğŸŒ†
dark	ğŸŒ†
sunset	ğŸŒ†
orange sky city	ğŸŒ†
evening	ğŸŒ†
bearer	â™’
greek	â™’
stars	â™’
aquarius	â™’
water	â™’
sign	â™’
astrology	â™’
constellation	â™’
zodiac	â™’
flag for armenia	ğŸ‡¦ğŸ‡²
regional indicator symbol letters am	ğŸ‡¦ğŸ‡²
mother christmas	ğŸ¤¶
mrs claus	ğŸ¤¶
clock face six oclock	ğŸ••
mouse face	ğŸ­
mouse	ğŸ­
mouse with whiskers	ğŸ­
fortress	ğŸ¯
fortified	ğŸ¯
residence	ğŸ¯
fort	ğŸ¯
japanese castle	ğŸ¯
royalty	ğŸ¯
castle	ğŸ¯
japanese	ğŸ¯
cow	ğŸ
endearment	ğŸ
ladybug	ğŸ
lady bug	ğŸ
lady beetle	ğŸ
lady	ğŸ
ladybird	ğŸ
bug	ğŸ
lady cow	ğŸ
insect	ğŸ
beetle	ğŸ
cheese	ğŸŒ™
moon	ğŸŒ™
phase	ğŸŒ™
sky	ğŸŒ™
night	ğŸŒ™
crescent moon	ğŸŒ™
waxing	ğŸŒ™
crescent	ğŸŒ™
black nose	ğŸ‘ƒğŸ¿
biohazard sign	â˜£
deeper brown mountain bicyclist	ğŸšµğŸ¾
multiple musical notes	ğŸ¶
music notes	ğŸ¶
musical	ğŸ¶
music	ğŸ¶
sound	ğŸ¶
melody	ğŸ¶
notes	ğŸ¶
singing	ğŸ¶
cloud with tornado	ğŸŒª
regional indicator symbol letters tc	ğŸ‡¹ğŸ‡¨
regional indicator symbol letter n	ğŸ‡³
black construction worker	ğŸ‘·ğŸ¿
gust of wind	ğŸ’¨
dash symbol	ğŸ’¨
fart	ğŸ’¨
wind	ğŸ’¨
steam	ğŸ’¨
fast	ğŸ’¨
cheese wedge	ğŸ§€
cheese	ğŸ§€
flag for algeria	ğŸ‡©ğŸ‡¿
regional indicator symbol letters dz	ğŸ‡©ğŸ‡¿
algerian flag	ğŸ‡©ğŸ‡¿
deeper brown girl	ğŸ‘§ğŸ¾
pushpin	ğŸ“Œ
thumb tack	ğŸ“Œ
fast forward	â©
medium white circle	âšª
abc	ğŸ”¤
alphabet	ğŸ”¤
letters	ğŸ”¤
input symbol for latin letters	ğŸ”¤
umbrella on ground	â›±
drooling face	ğŸ¤¤
drool	ğŸ¤¤
smooth	ğŸ˜
sun	ğŸ˜
sunny	ğŸ˜
sunglasses	ğŸ˜
sunnies	ğŸ˜
cool	ğŸ˜
smiling face with sunglasses	ğŸ˜
smiling	ğŸ˜
glasses	ğŸ˜
snapchat mutual best friends	ğŸ˜
olive toned face with ok gesture	ğŸ™†ğŸ½
slightly frowning face	ğŸ™
slightly sad	ğŸ™
cook	ğŸ³
fry	ğŸ³
frying pan	ğŸ³
flat	ğŸ³
utensil	ğŸ³
egg	ğŸ³
cooking	ğŸ³
frying	ğŸ³
fried egg	ğŸ³
pan	ğŸ³
breakfast	ğŸ³
cockerel	ğŸ“
cock	ğŸ“
male	ğŸ“
rooster	ğŸ“
crowing	ğŸ“
octagonal sign	ğŸ›‘
stop sign	ğŸ›‘
olive toned waving hand sign	ğŸ‘‹ğŸ½
gyro	ğŸš
helicopter	ğŸš
helo	ğŸš
gyrocopter	ğŸš
black pedestrian	ğŸš¶ğŸ¿
rock on	ğŸ‘
hitch hike	ğŸ‘
yes	ğŸ‘
good	ğŸ‘
thumb	ğŸ‘
up	ğŸ‘
hand	ğŸ‘
gesture	ğŸ‘
thumbs up	ğŸ‘
thumbs up sign	ğŸ‘
sign	ğŸ‘
approval	ğŸ‘
like	ğŸ‘
spoon	ğŸ¥„
short	ğŸ“
cake	ğŸ“
strawberries	ğŸ“
berry	ğŸ“
strawberry	ğŸ“
young	ğŸ£
cute	ğŸ£
baby chicken	ğŸ£
bird	ğŸ£
egg	ğŸ£
woman	ğŸ£
chick	ğŸ£
chicken	ğŸ£
baby	ğŸ£
chick hatching	ğŸ£
hatching chick	ğŸ£
rhinoceros	ğŸ¦
fragrant	ğŸŒ¹
red rose	ğŸŒ¹
flower	ğŸŒ¹
petals	ğŸŒ¹
love	ğŸŒ¹
romance	ğŸŒ¹
thorns	ğŸŒ¹
rose	ğŸŒ¹
red flower	ğŸŒ¹
cricket bat and ball	ğŸ
cricket	ğŸ
regional indicator symbol letters vc	ğŸ‡»ğŸ‡¨
black club suit	â™£ï¸
clubs	â™£ï¸
flag for dominica	ğŸ‡©ğŸ‡²
regional indicator symbol letters dm	ğŸ‡©ğŸ‡²
deeper brown white down pointing backhand index	ğŸ‘‡ğŸ¾
nerd face	ğŸ¤“
nerdy	ğŸ¤“
black square button	ğŸ”²
unicorn face	ğŸ¦„
unicorn	ğŸ¦„
cross mark	âŒ
cross	âŒ
x	âŒ
deeper brown flexed biceps	ğŸ’ªğŸ¾
face with rolling eyes	ğŸ™„
eye roll	ğŸ™„
push bike	ğŸš²
transportation	ğŸš²
pedal	ğŸš²
bicycle	ğŸš²
bike	ğŸš²
bowling	ğŸ³
strike	ğŸ³
bowling ball	ğŸ³
skittles	ğŸ³
ten pin bowling	ğŸ³
spare	ğŸ³
ball	ğŸ³
pins	ğŸ³
bowl	ğŸ³
pin	ğŸ³
game	ğŸ³
flag for france	ğŸ‡«ğŸ‡·
regional indicator symbol letters fr	ğŸ‡«ğŸ‡·
french flag	ğŸ‡«ğŸ‡·
nose	ğŸ‘ƒ
smelling	ğŸ‘ƒ
sniffing	ğŸ‘ƒ
stinky	ğŸ‘ƒ
worried face	ğŸ˜Ÿ
nervous	ğŸ˜Ÿ
worried	ğŸ˜Ÿ
distressed	ğŸ˜Ÿ
sad	ğŸ˜Ÿ
anxious	ğŸ˜Ÿ
tense	ğŸ˜Ÿ
sadface	ğŸ˜Ÿ
flag for antarctica	ğŸ‡¦ğŸ‡¶
robot face	ğŸ¤–
robot	ğŸ¤–
large blue circle	ğŸ”µ
keycap digit six	6âƒ£ï¸
fire	ğŸ‰
legendary	ğŸ‰
myth	ğŸ‰
dragon	ğŸ‰
downwards black arrow	â¬‡ï¸
latin cross	âœ
christian cross	âœ
brokenhearted	ğŸ’”
broken heart	ğŸ’”
breaking heart	ğŸ’”
heart broken	ğŸ’”
chart with upwards trend and yen sign	ğŸ’¹
wheel of dharma	â˜¸
ç„¡	ğŸˆš
lacking	ğŸˆš
mount fuji	ğŸ—»
admission tickets	ğŸŸ
flag for isle of man	ğŸ‡®ğŸ‡²
manx flag	ğŸ‡®ğŸ‡²
white person raising both hands in celebration	ğŸ™ŒğŸ»
flag for greenland	ğŸ‡¬ğŸ‡±
keycap digit five	5âƒ£ï¸
flag for kuwait	ğŸ‡°ğŸ‡¼
regional indicator symbol letters kw	ğŸ‡°ğŸ‡¼
white white right pointing backhand index	ğŸ‘‰ğŸ»
aerial tramway	ğŸš¡
gondola	ğŸš¡
tram	ğŸš¡
tramway	ğŸš¡
cable	ğŸš¡
transport	ğŸš¡
cable car	ğŸš¡
ropeway	ğŸš¡
aerial	ğŸš¡
flag for nigeria	ğŸ‡³ğŸ‡¬
regional indicator symbol letters ng	ğŸ‡³ğŸ‡¬
nigerian flag	ğŸ‡³ğŸ‡¬
military medal	ğŸ–
military decoration	ğŸ–
medal	ğŸ–
medallion	ğŸ–
elderly man	ğŸ‘´
old man	ğŸ‘´
older man	ğŸ‘´
grandpa	ğŸ‘´
south west arrow	â†™ï¸
olive toned man with gua pi mao	ğŸ‘²ğŸ½
rainy	â˜”
rain	â˜”
umbrella with rain drops	â˜”
raining	â˜”
umbrella	â˜”
north west arrow	â†–ï¸
flag for bangladesh	ğŸ‡§ğŸ‡©
regional indicator symbol letters bd	ğŸ‡§ğŸ‡©
flag for seychelles	ğŸ‡¸ğŸ‡¨
regional indicator symbol letters sc	ğŸ‡¸ğŸ‡¨
selfie	ğŸ¤³
clock face three oclock	ğŸ•’
black rowboat	ğŸš£ğŸ¿
deeper brown baby	ğŸ‘¶ğŸ¾
deeper brown man	ğŸ‘¨ğŸ¾
amphora	ğŸº
jar	ğŸº
vase	ğŸº
flag for Ã¥land islands	ğŸ‡¦ğŸ‡½
Ã¥land flag	ğŸ‡¦ğŸ‡½
black person bowing deeply	ğŸ™‡ğŸ¿
flu	ğŸ˜·
sars	ğŸ˜·
mask	ğŸ˜·
surgical mask	ğŸ˜·
doctor	ğŸ˜·
virus	ğŸ˜·
bird flu	ğŸ˜·
medical	ğŸ˜·
face with medical mask	ğŸ˜·
mask face	ğŸ˜·
sick	ğŸ˜·
city	ğŸš
bus	ğŸš
trolley	ğŸš
electric bus	ğŸš
transportation	ğŸš
transport	ğŸš
trolleybus	ğŸš
trolley bus	ğŸš
