regional indicator symbol letters sk	ğŸ‡¸ğŸ‡°	True
necktie	ğŸ‘”	True
weather	ğŸŒ€	True
throne	ğŸš¾	True
scary	ğŸ‘¹	True
shared	ğŸš»	True
team	ğŸ‘¬	True
flag for fiji	ğŸ‡«ğŸ‡¯	True
headphone	ğŸ§	True
food	ğŸ½	True
machine	ğŸšœ	True
cancer	â™‹	True
lungs	ğŸš­	True
feet	ğŸš·	True
july 17	ğŸ“…	True
barber shop	ğŸ’ˆ	True
heavy check mark	âœ”ï¸	True
light brown person with pouting face	ğŸ™ğŸ¼	True
martini	ğŸ¸	True
shrugging	ğŸ¤·	True
closed	ğŸŒ‚	True
ticket	ğŸš“	True
fish	ğŸ¤	True
heart with arrow	ğŸ’˜	True
oncoming police car	ğŸš”	True
dressing	ğŸ‘š	True
cute penguin	ğŸ§	True
noodles	ğŸ¥	True
leaf	ğŸµ	True
cutting	âœ‚ï¸	True
sight	ğŸ‘“	True
no entry	â›”	True
bearskin	ğŸ’‚	True
identification	ğŸ†”	True
perplex	ğŸ˜•	True
empress	ğŸ	True
white swimmer	ğŸŠğŸ»	True
heavy exclamation mark symbol	â—	True
balloon	ğŸ’­	True
chat bubble	ğŸ’¬	True
playing cards	ğŸ´	True
japanese ogre	ğŸ‘¹	True
sign	â™‰	True
scales	âš–	True
flag for indonesia	ğŸ‡®ğŸ‡©	True
motor cycle	ğŸ›µ	True
leftwards black arrow	â¬…ï¸	True
yellow book	ğŸ“’	True
pout	ğŸ˜¡	True
flag for morocco	ğŸ‡²ğŸ‡¦	True
swiss flag	ğŸ‡¨ğŸ‡­	True
soft	ğŸ¦	True
heavy exclamation mark symbol	â—ï¸	True
earth	ğŸŒ	True
ferris wheel	ğŸ¡	True
flag for zambia	ğŸ‡¿ğŸ‡²	True
face with thermometer	ğŸ¤’	True
unlock	ğŸ”“	True
music	ğŸ»	True
cat face with tears of joy	ğŸ˜¹	True
put litter in trash	ğŸš®	True
alien	ğŸ‘½	True
face	ğŸŒ	True
regional indicator symbol letters hu	ğŸ‡­ğŸ‡º	True
leopard	ğŸ†	True
flag for north korea	ğŸ‡°ğŸ‡µ	True
breaking heart	ğŸ’”	True
white father christmas	ğŸ…ğŸ»	True
olive toned white down pointing backhand index	ğŸ‘‡ğŸ½	True
penis	ğŸ†	True
olive toned nose	ğŸ‘ƒğŸ½	True
pig	ğŸ–	True
open lock	ğŸ”“	True
open	ğŸ˜®	True
eight pointed black star	âœ´ï¸	True
heavy division sign	â—	True
timepiece	âŒš	True
negative squared ab	ğŸ†	True
ghoul	ğŸ‘»	True
mount fuji	ğŸ—»	True
flag for cuba	ğŸ‡¨ğŸ‡º	True
worried	ğŸ˜Ÿ	True
bomb	ğŸ’£	True
help	ğŸ’	True
crab	ğŸ¦€	True
flag for ghana	ğŸ‡¬ğŸ‡­	True
high	ğŸ©	True
regional indicator symbol letter w	ğŸ‡¼	True
deeper brown white right pointing backhand index	ğŸ‘‰ğŸ¾	True
talk	ğŸ™Š	True
steamed rice	ğŸš	True
rice ball	ğŸ™	True
do not litter symbol	ğŸš¯	True
black woman	ğŸ‘©ğŸ¿	True
flag for france	ğŸ‡«ğŸ‡·	True
light brown princess	ğŸ‘¸ğŸ¼	True
crying cat	ğŸ˜¿	True
astonished	ğŸ˜²	True
regional indicator symbol letters mk	ğŸ‡²ğŸ‡°	True
1234	ğŸ”¢	True
nicotine	ğŸš¬	True
nail polish	ğŸ’…	True
swish	ğŸ€	True
glass	ğŸ·	True
see	ğŸ™ˆ	True
lesbian	ğŸ‘­	True
pooh	ğŸ¯	True
turrets	ğŸ°	True
printer	ğŸ–¨	True
dairy	ğŸ¨	True
instrument	ğŸ»	True
squared ok	ğŸ†—	True
weary face	ğŸ˜©	True
tada	ğŸ‰	True
lips sealed	ğŸ¤	True
fencer	ğŸ¥¡	True
medium black circle	âš«ï¸	True
japanese postal mark	ğŸ£	True
rose	ğŸŒ¹	True
burrito	ğŸŒ¯	True
disney	ğŸ°	True
idea	ğŸ†	True
right triangle	â–¶ï¸	True
purple crystal	ğŸ”®	True
banzai	ğŸ™Œ	True
squared vs	ğŸ†š	True
hands on head	ğŸ™†	True
school bag	ğŸ’	True
massaging	ğŸ’†	True
japanese symbol for beginner	ğŸ”°	True
sky	ğŸŒœ	True
cheese	ğŸŒ•	True
autumn	ğŸ‘	True
flushed face	ğŸ˜³	True
ocean	âš“	True
wednesday	ğŸ«	True
receptacle	ğŸš®	True
greek	â™	True
listening	ğŸ‘‚	True
shibuya 109 department store	î”Š	True
cha cha	ğŸ’ƒ	True
gasping face	ğŸ˜²	True
bear	ğŸ¼	True
cream	ğŸ¦	True
fish	ğŸ£	True
adam	ğŸ§	True
carousel	ğŸ 	True
tree	ğŸŒ´	True
monkey covering mouth	ğŸ™Š	True
conceited	ğŸ˜	True
baggage	ğŸ›…	True
bills	ğŸ’¶	True
excitement	ğŸ†	True
european	âš½	True
libra	â™	True
clock tower	ğŸ«	True
smiley	ğŸ˜ƒ	True
flag for slovenia	ğŸ‡¸ğŸ‡®	True
lock	ğŸ”’	True
tent	â›º	True
yield	ğŸš¥	True
bills	ğŸ’µ	True
lager	ğŸº	True
grey skull	ğŸ’€	True
sun	ğŸŒ…	True
bullant	ğŸœ	True
black club suit	â™£ï¸	True
ringer	ğŸ””	True
black face with ok gesture	ğŸ™†ğŸ¿	True
syringe	ğŸ’‰	True
quiz	ğŸ’¯	True
slice	ğŸ•	True
footprints	ğŸ‘£	True
bunch	ğŸŒ	True
potato	ğŸ¥”	True
frog face	ğŸ¸	True
white nose	ğŸ‘ƒğŸ»	True
crÃ¨me	ğŸ®	True
multiple	ğŸ’	True
olive toned older woman	ğŸ‘µğŸ½	True
nigerian flag	ğŸ‡³ğŸ‡¬	True
yield	ğŸš¦	True
boat with paddles	ğŸš£	True
two pink hearts	ğŸ’•	True
critter	ğŸ¾	True
regional indicator symbol letters kp	ğŸ‡°ğŸ‡µ	True
winter	ğŸ‚	True
hand	ğŸ‘	True
sign	â™‹	True
rodent	ğŸ€	True
train	ğŸš	True
heart	ğŸ˜»	True
motorway	ğŸ›£	True
words	ğŸ™Š	True
birthday	ğŸˆ	True
cat	ğŸ…	True
flag for honduras	ğŸ‡­ğŸ‡³	True
angry face	ğŸ˜¡	True
thanksgiving turkey	ğŸ¦ƒ	True
garden snail	ğŸŒ	True
weightlifting	ğŸ‹	True
earth globe americas	ğŸŒ	True
airport	âœˆï¸	True
money	ğŸ§	True
flag for cameroon	ğŸ‡¨ğŸ‡²	True
foot	ğŸš·	True
cry	ğŸ˜‚	True
hairdresser	ğŸ’ˆ	True
last quarter moon with face	ğŸŒœ	True
temperature	ğŸŒ¡	True
lock with fountain pen	ğŸ”	True
whistling	ğŸ˜™	True
solomon islander flag	ğŸ‡¸ğŸ‡§	True
mouth	ğŸ‘…	True
web	ğŸ•¸	True
flag for germany	ğŸ‡©ğŸ‡ª	True
family of a man and woman with two boys	ğŸ‘¨â€ğŸ‘©â€ğŸ‘¦â€ğŸ‘¦	True
sky	ğŸŒ’	True
drink	ğŸ¹	True
playful	ğŸ˜›	True
motorcycle	ğŸ	True
piggy	ğŸ–	True
vaccination	ğŸ’‰	True
marriage	ğŸ’’	True
dancers	ğŸ‘¯	True
special	â„ï¸	True
unamused face	ğŸ˜’	True
electric plug	ğŸ”Œ	True
phase	ğŸŒ‘	True
clothing	ğŸ‘š	True
mizaru	ğŸ™ˆ	True
motor	ğŸš¤	True
table tennis paddle and ball	ğŸ“	True
flat	ğŸ³	True
beef	ğŸ”	True
black happy person raising one hand	ğŸ™‹ğŸ¿	True
smiling	ğŸ˜€	True
pray	ğŸ™	True
poke	ğŸŒµ	True
bus	ğŸš	True
endearment	ğŸ¼	True
lemonade	ğŸ‹	True
shamrock	â˜˜	True
french	ğŸŒ	True
luck	ğŸ€	True
v sign	âœŒï¸	True
yam	ğŸ 	True
cheese	ğŸŒ—	True
shopping center	ğŸ¬	True
rip city	ğŸ€	True
train station	ğŸš‰	True
olive toned father christmas	ğŸ…ğŸ½	True
poultry leg	ğŸ—	True
olive toned raised hand with part between middle and ring fingers	ğŸ––ğŸ½	True
petrol pump	â›½	True
disapproval	ğŸ‘	True
dancing	ğŸ‘¯	True
plant	ğŸŒ±	True
girlfriends	ğŸ‘­	True
yen	ğŸ’´	True
deeper brown open hands sign	ğŸ‘ğŸ¾	True
mouse face	ğŸ­	True
ç¦	ğŸˆ²	True
snowman	â›„	True
sunrise over mountains	ğŸŒ„	True
fruit machine	ğŸ°	True
light brown raised hand with part between middle and ring fingers	ğŸ––ğŸ¼	True
young	ğŸ¤	True
full	ğŸˆµ	True
transportation	ğŸšŒ	True
oregon	ğŸº	True
event	ğŸª	True
saint nick	ğŸ…	True
peace	ğŸ‘³	True
traffic light	ğŸš¥	True
meal	ğŸ´	True
planning	ğŸ‘°	True
olive toned horse racing	ğŸ‡ğŸ½	True
compact disc	ğŸ’¿	True
slightly smiling face	ğŸ™‚	True
graduation cap	ğŸ“	True
squared ng	ğŸ†–	True
harbor	âš“	True
bicycle	ğŸšµ	True
regional indicator symbol letters eg	ğŸ‡ªğŸ‡¬	True
smoking	ğŸš¬	True
number 10	ğŸ”Ÿ	True
egg	ğŸ£	True
zodiac	â™“ï¸	True
flag for el salvador	ğŸ‡¸ğŸ‡»	True
white face with no good gesture	ğŸ™…ğŸ»	True
pregnant woman	ğŸ¤°	True
ice hockey	ğŸ’	True
png flag	ğŸ‡µğŸ‡¬	True
royal	ğŸ	True
horizontal traffic light	ğŸš¥	True
shibuya	î”Š	True
diamond	ğŸ’ 	True
stars	â™	True
christmas	ğŸ…	True
tennis racquet and ball	ğŸ¾	True
bride with veil	ğŸ‘°	True
bowling	ğŸ³	True
railway track	ğŸ›¤	True
nose	ğŸ‘º	True
facepalm	ğŸ¤¦	True
dominican flag	ğŸ‡©ğŸ‡´	True
steam train	ğŸš‚	True
paper	ğŸ’·	True
smith	ğŸ	True
skittles	ğŸ³	True
soon	ğŸ”œ	True
star of david	âœ¡	True
skullcap	ğŸ‘²	True
sedan	ğŸš˜	True
map pin	ğŸ“	True
registered sign	Â®ï¸	True
meteoroid	ğŸŒ 	True
cute	ğŸ£	True
halloween	ğŸƒ	True
love	ğŸ©	True
wallet	ğŸ’³	True
smiley face	ğŸ˜Š	True
fry	ğŸŸ	True
greek	â™Œï¸	True
raining	â˜”	True
regional indicator symbol letters gb	ğŸ‡¬ğŸ‡§	True
sneaker	ğŸ‘Ÿ	True
calendar	ğŸ“…	True
sign	â™	True
waste	ğŸš¯	True
quarter	ğŸŒ›	True
label	ğŸ·	True
white	ğŸ’®	True
hello	ğŸ‘‹	True
pranava	ğŸ•‰	True
smelling	ğŸ‘ƒ	True
pocket ball	ğŸ±	True
cake	ğŸ“	True
left speech bubble	ğŸ—¨	True
playboy	ğŸ‘¯	True
new york taxi	ğŸš•	True
flag for luxembourg	ğŸ‡±ğŸ‡º	True
scape	ğŸŒ‡	True
deeper brown thumbs down sign	ğŸ‘ğŸ¾	True
regional indicator symbol letter q	ğŸ‡¶	True
ticket	ğŸ«	True
spit	ğŸ’§	True
oncoming automobile	ğŸš˜	True
shop	ğŸ‘š	True
smiling	ğŸ˜	True
man and woman holding hands	ğŸ‘«	True
greek	â™‹ï¸	True
savoring	ğŸ˜‹	True
star trek	ğŸ––	True
bathroom	ğŸšº	True
quivering mouth	ğŸ˜–	True
flag for aruba	ğŸ‡¦ğŸ‡¼	True
weather	ğŸŒ	True
dog	ğŸ•	True
americas	ğŸŒ	True
constellation	â™Š	True
fish	ğŸŸ	True
white person with pouting face	ğŸ™ğŸ»	True
hoop	ğŸ€	True
slice of pizza	ğŸ•	True
sign	â™ˆ	True
sting	ğŸ	True
indian flag	ğŸ‡®ğŸ‡³	True
fair	ğŸ 	True
raised hand	âœ‹	True
race	ğŸ‡	True
no deal	ğŸ™…	True
seeds	ğŸŒ»	True
keycap digit nine	9ï¸âƒ£	True
â„¹ tourist information	â„¹ï¸	True
keycap digit five	5âƒ£ï¸	True
squared katakana koko	ğŸˆ	True
approval	ğŸ‘	True
broken heart	ğŸ’”	True
mcdonalds fries	ğŸŸ	True
bridge at night	ğŸŒ‰	True
imp	ğŸ‘¿	True
music	ğŸ	True
regional indicator symbol letters es	ğŸ‡ªğŸ‡¸	True
harvest	ğŸ	True
gifts	ğŸ…	True
black thumbs up sign	ğŸ‘ğŸ¿	True
train	ğŸš‰	True
retail	ğŸ¬	True
fall	ğŸƒ	True
black rowboat	ğŸš£ğŸ¿	True
love	ğŸ¼	True
linked paperclips	ğŸ–‡	True
strawberry shortcake	ğŸ°	True
side of taxi	ğŸš•	True
traffic	ğŸš¥	True
regional indicator symbol letters sd	ğŸ‡¸ğŸ‡©	True
lol	ğŸ˜‚	True
trolley bus	ğŸš	True
sisters	ğŸ‘­	True
tram	ğŸš¡	True
sport	ğŸ¯	True
up triangle	ğŸ”¼	True
black boy	ğŸ‘¦ğŸ¿	True
snot bubble	ğŸ˜ª	True
sailboat	â›µï¸	True
black small square	â–ªï¸	True
regional indicator symbol letter l	ğŸ‡±	True
alcohol	ğŸ¸	True
answer	ğŸ™‹	True
snoring	ğŸ˜´	True
wistful	ğŸ˜”	True
moon	ğŸŒ	True
paper	ğŸ’¶	True
regional indicator symbol letters am	ğŸ‡¦ğŸ‡²	True
stop	ğŸš	True
skier	â›·	True
regional indicator symbol letters ng	ğŸ‡³ğŸ‡¬	True
artist	ğŸ˜±	True
cigarette	ğŸš¬	True
envelope with lines	ğŸ“¨	True
squared up with exclamation mark	ğŸ†™	True
train	ğŸšŸ	True
blue face	ğŸ˜°	True
bouquet	ğŸ’	True
holding	ğŸ‘¬	True
clean	ğŸš°	True
smoking	ğŸš­	True
eight spoked asterisk	âœ³ï¸	True
transport	ğŸš•	True
protective	ğŸ	True
input symbol for numbers	ğŸ”¢	True
green	ğŸ€	True
motor bike	ğŸ›µ	True
face	ğŸŒš	True
ice	ğŸ¨	True
fishcake	ğŸ¥	True
lolly	ğŸ¬	True
reduce volume	ğŸ”‰	True
currency exchange	ğŸ’±	True
volleyball	ğŸ	True
breakfast	ğŸ©	True
new moon symbol	ğŸŒ‘	True
cd	ğŸ’¿	True
ill	ğŸ¤’	True
evil	â¤ï¸	True
olive toned bride with veil	ğŸ‘°ğŸ½	True
devil	ğŸ‘¿	True
light brown surfer	ğŸ„ğŸ¼	True
afghan flag	ğŸ‡¦ğŸ‡«	True
heart	ğŸ’œ	True
comic	ğŸ’¬	True
deck of cards	ğŸ´	True
warning sign	âš ï¸	True
bathtub	ğŸ›	True
cake with candles	ğŸ‚	True
woodwind	ğŸ·	True
celebration	ğŸ†	True
bessie	ğŸ„	True
double vertical bar	â¸	True
school	ğŸ™€	True
utensil	ğŸ³	True
regional indicator symbol letters cd	ğŸ‡¨ğŸ‡©	True
hot beverage	â˜•ï¸	True
pride	ğŸŒˆ	True
entry	ğŸšª	True
rÃ©unionnais flag	ğŸ‡·ğŸ‡ª	True
woman	ğŸ‘©	True
power cable	ğŸ”Œ	True
speedboat	ğŸš¤	True
entrance	ğŸšª	True
zodiac	â™ï¸	True
vomit	ğŸ¤¢	True
farris	ğŸ¡	True
flag for montenegro	ğŸ‡²ğŸ‡ª	True
outbox tray	ğŸ“¤	True
bellhop	ğŸ’	True
flag for rwanda	ğŸ‡·ğŸ‡¼	True
regional indicator symbol letter p	ğŸ‡µ	True
colors	ğŸ¨	True
sleeping symbol	ğŸ’¤	True
cheese	ğŸŒ’	True
athletic shoe	ğŸ‘Ÿ	True
gypsy	ğŸ”®	True
coffin	âš°	True
balls	ğŸ¡	True
medium white circle	âšªï¸	True
garbage	ğŸš®	True
smoke	ğŸš­	True
road	ğŸš´	True
sports	ğŸ½	True
dizzy	ğŸ˜µ	True
pink	â¤ï¸	True
regional indicator symbol letters ne	ğŸ‡³ğŸ‡ª	True
disappoint	ğŸ˜¥	True
optical disc	ğŸ’¿	True
conversation	ğŸ’¬	True
guadeloupean flag	ğŸ‡¬ğŸ‡µ	True
eye	ğŸ‘	True
fox	ğŸº	True
thought balloon	ğŸ’­	True
mountain railway	ğŸš	True
american express	ğŸ’³	True
recreational vehicle	ğŸš™	True
archer	â™	True
loaf of bread	ğŸ	True
flag for angola	ğŸ‡¦ğŸ‡´	True
music	ğŸ¸	True
symbol input	ğŸ”£	True
stick	ğŸ­	True
airbus	âœˆï¸	True
stars	ğŸŒŒ	True
couple kissing	ğŸ’	True
pink flower	ğŸŒ¸	True
bermudan flag	ğŸ‡§ğŸ‡²	True
trousers	ğŸ‘–	True
constellation	â™‹ï¸	True
shipyard	âš“	True
olive toned fisted hand sign	ğŸ‘ŠğŸ½	True
cue ball	ğŸ±	True
fletching	ğŸ¯	True
white up pointing backhand index	ğŸ‘†	True
transport	ğŸš	True
couch and lamp	ğŸ›‹	True
farming	ğŸŒ¾	True
trophy	ğŸ†	True
smiley sun	ğŸŒ	True
sun	ğŸŒ‚	True
lava	ğŸŒ‹	True
court	ğŸ¾	True
grinning face with smiling eyes	ğŸ˜	True
city	ğŸŒ‡	True
surf	ğŸ„	True
casket	âš°	True
light brown older man	ğŸ‘´ğŸ¼	True
barley	ğŸº	True
night	ğŸŒ 	True
deeper brown woman	ğŸ‘©ğŸ¾	True
light brown face with no good gesture	ğŸ™…ğŸ¼	True
marriage	ğŸ‘°	True
izakaya lantern	ğŸ®	True
smiley	ğŸ˜„	True
head massage	ğŸ’†	True
keycap digit one	1âƒ£ï¸	True
stub	ğŸ«	True
grass	ğŸ‘	True
flower	ğŸ’®	True
rage	ğŸ˜¡	True
pole	ğŸ£	True
astrology	â™’ï¸	True
curry	ğŸ›	True
whistle	ğŸ˜™	True
clippy	ğŸ“	True
regional indicator symbol letters sr	ğŸ‡¸ğŸ‡·	True
snowman without snow	â›„ï¸	True
regional indicator symbol letters lt	ğŸ‡±ğŸ‡¹	True
semi	ğŸš›	True
bullet	ğŸš…	True
middle finger	ğŸ–•	True
hog	ğŸ–	True
heat	ğŸª	True
gyrocopter	ğŸš	True
regional indicator symbol letters ke	ğŸ‡°ğŸ‡ª	True
authority	ğŸ›ƒ	True
regional indicator symbol letters pr	ğŸ‡µğŸ‡·	True
pink white green balls	ğŸ¡	True
nigiri	ğŸ£	True
regional indicator symbol letters hk	ğŸ‡­ğŸ‡°	True
regional indicator symbol letters pw	ğŸ‡µğŸ‡¼	True
tofu on fire	ğŸ“›	True
singlet	ğŸ½	True
sweat	ğŸ˜…	True
negative squared latin capital letter b	ğŸ…±ï¸	True
entertainment	ğŸ­	True
casserole	ğŸ¢	True
boy and girl kissing	ğŸ’	True
zodiac	â™ï¸	True
somber	ğŸ˜¿	True
lacking	ğŸˆš	True
older man	ğŸ‘´	True
dwelling	ğŸ 	True
ocean	âš“ï¸	True
old key	ğŸ—	True
inebriated	ğŸ˜µ	True
minidisc	ğŸ’½	True
happy sweat	ğŸ˜…	True
instrument	ğŸ¹	True
horns	ğŸ˜ˆ	True
boat	ğŸš¤	True
new caledonian flag	ğŸ‡³ğŸ‡¨	True
regional indicator symbol letters vn	ğŸ‡»ğŸ‡³	True
newspaper	ğŸ“°	True
keycap digit seven	7ï¸âƒ£	True
couple love	ğŸ’	True
water	ğŸš°	True
cry	ğŸ˜¿	True
hops	ğŸ»	True
hit	ğŸ¯	True
australia	ğŸ’µ	True
wink	ğŸ˜‰	True
hot	ğŸµ	True
ring	ğŸ’	True
stroll	ğŸš¶	True
olive toned person bowing deeply	ğŸ™‡ğŸ½	True
insect	ğŸ	True
lollypop	ğŸ­	True
thick	ğŸ²	True
taxicab	ğŸš•	True
raccoon	ğŸ¾	True
seafood	ğŸ¢	True
friends	ğŸ‘¬	True
flag for armenia	ğŸ‡¦ğŸ‡²	True
summer	ğŸ‰	True
farming	ğŸ	True
dragon face	ğŸ²	True
flag for nepal	ğŸ‡³ğŸ‡µ	True
person	ğŸ‘¤	True
sky	ğŸŒŒ	True
sad	ğŸ˜	True
singing	ğŸ¶	True
flag for anguilla	ğŸ‡¦ğŸ‡®	True
kissing lips	ğŸ‘„	True
human rock carving	ğŸ—¿	True
lights	ğŸŒ†	True
enter	ğŸšª	True
space shuttle	ğŸš€	True
womans clothes	ğŸ‘š	True
black person with blond hair	ğŸ‘±ğŸ¿	True
newborn	ğŸ¼	True
national park	ğŸ	True
karaoke	ã€½ï¸	True
night	ğŸŒ	True
snake	ğŸ	True
keycap digit four	4âƒ£ï¸	True
package	ğŸ“¦	True
sign	â™Œ	True
i	ğŸ‘¤	True
wheelchair symbol	â™¿ï¸	True
running shirt	ğŸ½	True
zodiac	â™’	True
flag for palestinian territories	ğŸ‡µğŸ‡¸	True
flag for iraq	ğŸ‡®ğŸ‡¶	True
planets	ğŸŒƒ	True
director	ğŸ¬	True
mask face	ğŸ˜·	True
holiday	ğŸ…	True
gay	ğŸ‘¬	True
womans hat	ğŸ‘’	True
pointing to phone	ğŸ“²	True
snapstreak	ğŸ”¥	True
scorpio	â™ï¸	True
percent	ğŸ’¯	True
toadfish	ğŸ¡	True
amusement	ğŸ¢	True
droplet	ğŸ’§	True
australia	ğŸ¨	True
sprouting	ğŸŒ±	True
sale	ğŸ¬	True
cat	ğŸ¾	True
financial	ğŸ§	True
golden	ğŸŒ‰	True
day calendar	ğŸ“†	True
winning	ğŸ™Œ	True
red circle	â­•	True
taxi	ğŸš–	True
sport	ğŸ‰	True
no walking	ğŸš·	True
leaf	ğŸ€	True
hard work	ğŸ˜“	True
ticket	ğŸš”	True
dingo	ğŸº	True
attitude	ğŸ’	True
sky	ğŸŒ—	True
small hearts	ğŸ’•	True
desert	ğŸœ	True
cook	ğŸŒ¿	True
music	ã€½ï¸	True
hotel	ğŸ¨	True
happiness	ğŸ	True
austrian flag	ğŸ‡¦ğŸ‡¹	True
regional indicator symbol letters gy	ğŸ‡¬ğŸ‡¾	True
tigger	ğŸ…	True
cheese	ğŸŒ–	True
flag for botswana	ğŸ‡§ğŸ‡¼	True
om symbol	ğŸ•‰	True
news	ğŸ“°	True
death	ğŸ’€	True
tower	ğŸ°	True
chick	ğŸ£	True
restroom	ğŸš½	True
jazz hands	ğŸ‘	True
morning	ğŸŒ‡	True
rabbit	ğŸ‡	True
flag for martinique	ğŸ‡²ğŸ‡¶	True
dribble	ğŸ€	True
dice	ğŸ²	True
leg	ğŸ—	True
turtle	ğŸ¢	True
grinning cat	ğŸ˜¸	True
flower playing cards	ğŸ´	True
card file box	ğŸ—ƒ	True
sleuth or spy	ğŸ•µ	True
ladybug	ğŸ	True
birthday	ğŸ‚	True
sick	ğŸ˜·	True
confound	ğŸ˜–	True
meal	ğŸ±	True
apple	ğŸ	True
soccer ball	âš½	True
park	ğŸ¢	True
myth	ğŸ‰	True
laughing crying	ğŸ˜‚	True
smiley	ğŸ˜º	True
tired face	ğŸ˜«	True
hot dog	ğŸŒ­	True
spiral	ğŸŒ€	True
syrup	ğŸ§	True
fronds	ğŸŒ´	True
pasta	ğŸ	True
typhoon	ğŸŒ€	True
frown	ğŸ™	True
two hearts	ğŸ’	True
monkey	ğŸ™‰	True
regional indicator symbol letters ph	ğŸ‡µğŸ‡­	True
spider	ğŸ•·	True
painting	ğŸ–¼	True
buzz	ğŸ	True
pencil	âœï¸	True
fearful	ğŸ˜¨	True
pc	ğŸ’»	True
volume	ğŸ”ˆ	True
regional indicator symbol letters dz	ğŸ‡©ğŸ‡¿	True
lost	ğŸ’¸	True
laps	ğŸŠ	True
rice wine	ğŸ¶	True
flag for mongolia	ğŸ‡²ğŸ‡³	True
ferry	ğŸš¢	True
monkey covering eyes	ğŸ™ˆ	True
scream	ğŸ™€	True
grid girl	ğŸ	True
seaweed	ğŸ™	True
restroom	ğŸšº	True
dessert	ğŸ¨	True
black pedestrian	ğŸš¶ğŸ¿	True
greek	â™‘ï¸	True
hotel	ğŸ©	True
curtsy	ğŸ™‡	True
scared cat	ğŸ™€	True
regional indicator symbol letters ht	ğŸ‡­ğŸ‡¹	True
ok	ğŸ™†	True
sheep	ğŸ	True
bouquet of flowers	ğŸ’	True
dessert	ğŸ‚	True
light brown fisted hand sign	ğŸ‘ŠğŸ¼	True
hands	ğŸ‘­	True
baked potato	ğŸ¥”	True
city	ğŸš	True
purple	ğŸ†	True
holiday	ğŸ	True
suv	ğŸš™	True
member	ğŸ‘¤	True
breath	ğŸ˜¤	True
bacon	ğŸ–	True
dessert	ğŸ®	True
snow cone	ğŸ§	True
israeli flag	ğŸ‡®ğŸ‡±	True
eat	ğŸ´	True
legendary	ğŸ²	True
pig head	ğŸ·	True
white	ğŸš	True
kitten paw prints	ğŸ¾	True
bird	ğŸ£	True
money bag	ğŸ’°	True
crab	â™‹ï¸	True
black white up pointing backhand index	ğŸ‘†ğŸ¿	True
rightwards arrow with hook	â†ªï¸	True
polo shirt	ğŸ‘•	True
magnifier	ğŸ”	True
october	ğŸƒ	True
cricket	ğŸ	True
man in tuxedo	ğŸ¤µ	True
olive toned dancer	ğŸ’ƒğŸ½	True
tent	â›ºï¸	True
light brown white right pointing backhand index	ğŸ‘‰ğŸ¼	True
truth	ğŸ’™	True
veil	ğŸ‘°	True
score	ğŸ’¯	True
pucker	ğŸ˜—	True
theme park	ğŸ¢	True
flag for guam	ğŸ‡¬ğŸ‡º	True
city	ğŸš	True
telephone	â˜ï¸	True
flag for cook islands	ğŸ‡¨ğŸ‡°	True
religious building	ğŸ›	True
meridian	ğŸŒ	True
engagement ring	ğŸ’	True
flag for vatican city	ğŸ‡»ğŸ‡¦	True
420	ğŸ‘Œ	True
triangular	ğŸš©	True
spoon	ğŸ¥„	True
tree	ğŸ‹	True
crop	ğŸŒ¿	True
fugu	ğŸ¡	True
pound note	ğŸ’·	True
tall	ğŸ©	True
satchel	ğŸ’	True
ball	ğŸ³	True
fist pump	âœŠ	True
confuse	ğŸ˜•	True
eat	ğŸ˜‹	True
high voltage sign	âš¡	True
dhikr beads	ğŸ“¿	True
evergreen tree	ğŸŒ²	True
eyesight	ğŸ‘€	True
beer	ğŸº	True
double bump camel	ğŸ«	True
board	ğŸ¬	True
emergency	ğŸš’	True
smiley	ğŸ˜	True
bottle	ğŸ¶	True
dead	ğŸƒ	True
yay	ğŸ™Œ	True
relieved	ğŸ˜Œ	True
rosary beads	ğŸ“¿	True
hugs	ğŸ¤—	True
regional indicator symbol letters ve	ğŸ‡»ğŸ‡ª	True
ear	ğŸŒ¾	True
answering question	ğŸ™‹	True
xmas tree	ğŸ„	True
insert in envelope	ğŸ“©	True
bbq	ğŸ–	True
regional indicator symbol letters vu	ğŸ‡»ğŸ‡º	True
male	ğŸ	True
zodiac	â™	True
dancing girls	ğŸ‘¯	True
waving white flag	ğŸ³	True
bat	ğŸ¦‡	True
algerian flag	ğŸ‡©ğŸ‡¿	True
regional indicator symbol letters cv	ğŸ‡¨ğŸ‡»	True
mobile phone with rightwards arrow at left	ğŸ“²	True
dizzy	ğŸ’«	True
face	ğŸŒ›	True
finish	ğŸ	True
abcd	ğŸ”¡	True
boeing	âœˆï¸	True
mark	ğŸ¾	True
paper	ğŸ’´	True
smiling	ğŸ˜ƒ	True
zodiac	â™’ï¸	True
pineapple	ğŸ	True
no good	ğŸ†–	True
sound	ğŸ¤	True
cancer	â™‹ï¸	True
fog bridge	ğŸŒ	True
love	ğŸ’œ	True
light brown nose	ğŸ‘ƒğŸ¼	True
souvlaki	ğŸ¥™	True
die	ğŸ²	True
koala	ğŸ¨	True
light rail	ğŸšˆ	True
battery	ğŸ”‹	True
credit card	ğŸ’³	True
disapprove	ğŸ˜¬	True
hot springs	â™¨ï¸	True
white sun behind cloud	ğŸŒ¥	True
pony	ğŸ	True
man dancing	ğŸ•º	True
education	ğŸ«	True
starry night	ğŸŒƒ	True
family of two men with one girl	ğŸ‘¨â€ğŸ‘¨â€ğŸ‘§	True
sound	ğŸ	True
saxophone	ğŸ·	True
hocho	ğŸ”ª	True
sick	ğŸ¤¢	True
central asia	ğŸ«	True
olive toned raised fist	âœŠğŸ½	True
tiger	ğŸ…	True
powder	ğŸ¿	True
plumbing	ğŸš¾	True
snake flag of martinique	ğŸ‡²ğŸ‡¶	True
deeper brown rowboat	ğŸš£ğŸ¾	True
playing	ğŸ´	True
arts	ğŸ­	True
regional indicator symbol letters gu	ğŸ‡¬ğŸ‡º	True
new	ğŸŒš	True
black person frowning	ğŸ™ğŸ¿	True
yellow flower	ğŸŒ¼	True
back with leftwards arrow above	ğŸ”™	True
spooky	ğŸŒ•	True
black raised hand	âœ‹ğŸ¿	True
centaur	â™	True
notes	ğŸ¶	True
clapper board	ğŸ¬	True
soak	ğŸ›	True
video game	ğŸ®	True
transportation	ğŸšŸ	True
medium white circle	âšª	True
ogre	ğŸ‘¹	True
string	ğŸ¸	True
cobweb	ğŸ•¸	True
black heart	ğŸ–¤	True
bike	ğŸšµ	True
treble clef	ğŸ¼	True
regional indicator symbol letters az	ğŸ‡¦ğŸ‡¿	True
flag for south africa	ğŸ‡¿ğŸ‡¦	True
astrology	â™‘	True
cross	â	True
hurt	ğŸ˜­	True
flag	ğŸš©	True
thoughtful	ğŸ˜”	True
x	â	True
phone heart	ğŸ“³	True
heart	ğŸ’•	True
deeper brown white down pointing backhand index	ğŸ‘‡ğŸ¾	True
music note	ğŸµ	True
card	ğŸ’³	True
face throwing a kiss	ğŸ˜˜	True
gambling	ğŸ°	True
light brown person with folded hands	ğŸ™ğŸ¼	True
regional indicator symbol letters ws	ğŸ‡¼ğŸ‡¸	True
dessert stick	ğŸ¡	True
shrug	ğŸ¤·	True
silly	ğŸ˜œ	True
ç„¡	ğŸˆš	True
bottle feeding	ğŸ¼	True
pouting face	ğŸ˜¡	True
man in suit	ğŸ¤µ	True
bear face	ğŸ»	True
phase	ğŸŒ˜	True
european flag	ğŸ‡ªğŸ‡º	True
regional indicator symbol letters tc	ğŸ‡¹ğŸ‡¨	True
regional indicator symbol letter j	ğŸ‡¯	True
happy cow	ğŸ®	True
top	ğŸ©	True
sky	ğŸŒ•	True
medical	ğŸ¥	True
vain	ğŸ©	True
flag for brunei	ğŸ‡§ğŸ‡³	True
cake	ğŸ‚	True
planet	ğŸŒ	True
sign	ğŸš»	True
no drinking water	ğŸš±	True
glow	ğŸŒŸ	True
hump	ğŸ«	True
sweat	ğŸ’§	True
â„¹ lowercase i	â„¹ï¸	True
hairdresser	ğŸ’‡	True
christmas present	ğŸ	True
macbook	ğŸ’»	True
gala apple	ğŸ	True
deeper brown man with turban	ğŸ‘³ğŸ¾	True
anthropomorphic	ğŸŒœ	True
gold	ğŸŒˆ	True
droplet	â„ï¸	True
police siren	ğŸš¨	True
calvary	ğŸ	True
acorn	ğŸŒ°	True
spiral bound book	ğŸ“’	True
city	ğŸš	True
horns	ğŸ‘¹	True
sign	â™‹ï¸	True
showy	ğŸ©	True
stars	â™’ï¸	True
grevenstein apple	ğŸ	True
breakfast	ğŸ³	True
bactrian camel	ğŸ«	True
regional indicator symbol letters ad	ğŸ‡¦ğŸ‡©	True
stars	â™“	True
video camera	ğŸ“¹	True
banknote	ğŸ’µ	True
audio	ğŸ§	True
candelabrum	ğŸ•	True
barbers stripes	ğŸ’ˆ	True
happy	ğŸ˜¹	True
vision	ğŸ‘“	True
world	ğŸŒ	True
marijuana	ğŸ‘Œ	True
barbadian flag	ğŸ‡§ğŸ‡§	True
no bicycles	ğŸš³	True
suggestive smile	ğŸ˜	True
iphone	ğŸ“±	True
disneyland	ğŸ°	True
white person bowing deeply	ğŸ™‡ğŸ»	True
virus	ğŸ›	True
flag for japan	ğŸ‡¯ğŸ‡µ	True
tick	âœ…	True
pistol	ğŸ”«	True
flag for macau	ğŸ‡²ğŸ‡´	True
below zero	â„ï¸	True
shibuya 109	î”Š	True
sun	ğŸŒ„	True
flag for seychelles	ğŸ‡¸ğŸ‡¨	True
mountain	ğŸŒ„	True
astrology	â™ˆ	True
golf clap	ğŸ‘	True
red flower	ğŸŒ¹	True
synagogue	ğŸ•	True
moyai statue	ğŸ—¿	True
smiling face with open mouth	ğŸ˜ƒ	True
no	ğŸš«	True
admission	ğŸ«	True
drunk face	ğŸ˜²	True
pisces	â™“	True
princess	ğŸ°	True
quarter	ğŸŒ—	True
triangular flag on post	ğŸš©	True
primate	ğŸ’	True
speaker with one sound wave	ğŸ”‰	True
golf	ğŸš©	True
family of a man and woman with one girl and one boy	ğŸ‘¨â€ğŸ‘©â€ğŸ‘§â€ğŸ‘¦	True
surprised	ğŸ˜¨	True
swell	ğŸ„	True
regional indicator symbol letters jp	ğŸ‡¯ğŸ‡µ	True
medical	ğŸš’	True
wrap	ğŸŒ¯	True
smirking cat	ğŸ˜¼	True
stars	â™ï¸	True
regional indicator symbol letters tn	ğŸ‡¹ğŸ‡³	True
gear	âš™	True
freshwater fish	ğŸŸ	True
regional indicator symbol letters ag	ğŸ‡¦ğŸ‡¬	True
keycap digit three	3âƒ£ï¸	True
olive toned baby	ğŸ‘¶ğŸ½	True
japanese	ğŸ	True
moon	ğŸŒ”	True
pawsteps	ğŸ¾	True
cancer	ğŸš¬	True
envelope	âœ‰ï¸	True
flag for sint maarten	ğŸ‡¸ğŸ‡½	True
light brown man	ğŸ‘¨ğŸ¼	True
victory	ğŸ‰	True
olive toned rowboat	ğŸš£ğŸ½	True
fragrant	ğŸŒ¹	True
candle	ğŸ•¯	True
tasting	ğŸ·	True
lovestruck	ğŸ˜	True
august	ğŸ´	True
happy	ğŸ©	True
lock and pen	ğŸ”	True
cat face with wry smile	ğŸ˜¼	True
caymanian flag	ğŸ‡°ğŸ‡¾	True
currency	ğŸ’µ	True
fort	ğŸ°	True
chilly	â„ï¸	True
space invader	ğŸ‘¾	True
railway	ğŸšƒ	True
rice	ğŸ™	True
control knobs	ğŸ›	True
sun	ğŸŒ	True
face palm	ğŸ¤¦	True
love	ğŸ’•	True
selfie	ğŸ¤³	True
fortified	ğŸ°	True
machine	ğŸ°	True
dogeza	ğŸ™‡	True
gate	ğŸŒ‰	True
regional indicator symbol letters cm	ğŸ‡¨ğŸ‡²	True
astrology	â™ï¸	True
watch	âŒš	True
white sun behind cloud with rain	ğŸŒ¦	True
fire	ğŸ‰	True
candy	ğŸ¬	True
cactus	ğŸŒµ	True
gabonese flag	ğŸ‡¬ğŸ‡¦	True
convenience store	ğŸª	True
japan post	ğŸ£	True
note	ğŸ“	True
sign	â™‘	True
song	ã€½ï¸	True
bolivian flag	ğŸ‡§ğŸ‡´	True
satisfied	ğŸ˜Œ	True
regional indicator symbol letters pe	ğŸ‡µğŸ‡ª	True
male restroom	ğŸš¹	True
ice skate	â›¸	True
ice	â„ï¸	True
poo	ğŸ’©	True
eagle	ğŸ¦…	True
spirits	ğŸ	True
rowboat	ğŸš£	True
cowboy	ğŸ¤ 	True
regional indicator symbol letters ki	ğŸ‡°ğŸ‡®	True
card index dividers	ğŸ—‚	True
deeper brown white left pointing backhand index	ğŸ‘ˆğŸ¾	True
rural	ğŸŒ„	True
sign	â™	True
rv	ğŸš™	True
night	ğŸŒœ	True
aqua	ğŸš±	True
honey	ğŸ¯	True
race	ğŸ	True
lock with ink pen	ğŸ”	True
olive toned boy	ğŸ‘¦ğŸ½	True
izakaya	ğŸ®	True
shoe	ğŸ‘	True
girls holding hands	ğŸ‘­	True
sleeping face	ğŸ˜´	True
tulip	ğŸŒ·	True
walt jabsco	ğŸ•´	True
water	ğŸŠ	True
couple	ğŸ‘­	True
flag for taiwan	ğŸ‡¹ğŸ‡¼	True
running	ğŸ½	True
kiss with two men	ğŸ‘¨â€â¤ï¸â€ğŸ’‹â€ğŸ‘¨	True
bell	ğŸ	True
seeing	ğŸ‘€	True
shirt	ğŸ‘š	True
norfolk island flag	ğŸ‡³ğŸ‡«	True
heat	ğŸ«	True
embarrassed	ğŸ˜³	True
new years	ğŸŠ	True
screw	ğŸ”©	True
american samoan flag	ğŸ‡¦ğŸ‡¸	True
star	ğŸ’«	True
flag for british indian ocean territory	ğŸ‡®ğŸ‡´	True
park	ğŸ 	True
bathroom	ğŸš½	True
f1	ğŸ	True
olive toned person raising both hands in celebration	ğŸ™ŒğŸ½	True
regional indicator symbol letters aw	ğŸ‡¦ğŸ‡¼	True
japanese	ğŸ‘º	True
deeper brown pedestrian	ğŸš¶ğŸ¾	True
baggage claim	ğŸ›„	True
signature	ğŸ’³	True
astrology	â™ï¸	True
brewery	ğŸº	True
construction sign	ğŸš§	True
regional indicator symbol letters tg	ğŸ‡¹ğŸ‡¬	True
heart decoration	ğŸ’Ÿ	True
regional indicator symbol letters se	ğŸ‡¸ğŸ‡ª	True
lame	ğŸ˜’	True
melon	ğŸ‰	True
stars	â™‘ï¸	True
regional indicator symbol letters mw	ğŸ‡²ğŸ‡¼	True
laptop	ğŸ’»	True
asian man	ğŸ‘²	True
white white left pointing backhand index	ğŸ‘ˆğŸ»	True
bang	ğŸ’¥	True
crystal ball	ğŸ”®	True
lower left paintbrush	ğŸ–Œ	True
winter	ğŸ¿	True
snowman without snow	â›„	True
deeper brown thumbs up sign	ğŸ‘ğŸ¾	True
white nail polish	ğŸ’…ğŸ»	True
sound	ğŸ¶	True
cheese	ğŸŒ	True
circus tent	ğŸª	True
skull	ğŸ’€	True
growing heart	ğŸ’—	True
motel	ğŸ¨	True
light bulb	ğŸ’¡	True
pointing up	ğŸ‘†	True
stadium	ğŸŸ	True
beetle	ğŸ	True
helium	ğŸˆ	True
no	ğŸš¯	True
disappoint	ğŸ˜	True
two women holding hands	ğŸ‘­	True
japanese	ğŸ±	True
fog	ğŸŒ«	True
reversed hand with middle finger extended	ğŸ–•	True
puzzle	ğŸ˜–	True
night	ğŸŒ›	True
mother nature	ğŸŒ¬	True
diamonds	â™¦ï¸	True
toilet	ğŸš½	True
alarm	â°	True
yin yang	â˜¯	True
moai	ğŸ—¿	True
bicep	ğŸ’ª	True
key	ğŸ”‘	True
two	ğŸ’•	True
capsule	ğŸ’Š	True
flag for barbados	ğŸ‡§ğŸ‡§	True
regional indicator symbol letters gi	ğŸ‡¬ğŸ‡®	True
dancer	ğŸ’ƒ	True
transport	ğŸš–	True
ham	ğŸ–	True
white up pointing index	â˜ï¸	True
fire truck	ğŸš’	True
acoustic	ğŸ¸	True
disappointed but relieved face	ğŸ˜¥	True
dark moon	ğŸŒ‘	True
cow	ğŸ”	True
couple with heart with two women	ğŸ‘©â€â¤ï¸â€ğŸ‘©	True
sikh	ğŸ‘³	True
wisdom	ğŸ‘³	True
depressed	ğŸ˜	True
mug	ğŸº	True
doctor	ğŸ	True
emotion	ğŸ’•	True
face with no good gesture	ğŸ™…	True
scales	â™ï¸	True
ledger	ğŸ“’	True
atm	ğŸ§	True
five hand	ğŸ–	True
mastercard	ğŸ’³	True
boar	ğŸ—	True
jog	ğŸƒ	True
breaststroke	ğŸŠ	True
regional indicator symbol letters cn	ğŸ‡¨ğŸ‡³	True
purse	ğŸ‘›	True
clean	ğŸš¿	True
m	ã€½ï¸	True
poultry	ğŸ”	True
glasses	ğŸ˜	True
womens symbol	ğŸšº	True
waste	ğŸš½	True
investigator	ğŸ”	True
high school	ğŸ«	True
waxing	ğŸŒ”	True
bugs bunny	ğŸ°	True
woof	ğŸ•	True
trackball	ğŸ–²	True
fish	ğŸ¥	True
soap	ğŸš¿	True
black man	ğŸ‘¨ğŸ¿	True
bulb	ğŸ’¡	True
treat	ğŸ§	True
screaming face	ğŸ˜±	True
circle	ğŸ’	True
fingers crossed	ğŸ¤	True
japanese dolls	ğŸ	True
ocean	ğŸŒŠ	True
chicken	ğŸ—	True
smiling cat face with open mouth	ğŸ˜º	True
reverse arrows	ğŸ”„	True
flag for antarctica	ğŸ‡¦ğŸ‡¶	True
finals	ğŸ˜©	True
sorry	ğŸ™‡	True
jazz	ğŸº	True
car hood	ğŸš˜	True
sleeping accommodation	ğŸ›Œ	True
scene	ğŸ‘	True
rejected	ğŸ™	True
regional indicator symbol letters mz	ğŸ‡²ğŸ‡¿	True
light brown baby angel	ğŸ‘¼ğŸ¼	True
black surfer	ğŸ„ğŸ¿	True
lips	ğŸ‘„	True
ok hand sign	ğŸ‘Œ	True
imprints	ğŸ¾	True
food	ğŸŒ¾	True
flag for oman	ğŸ‡´ğŸ‡²	True
shaking hands	ğŸ¤	True
not drinkable	ğŸš±	True
tea	â˜•	True
deeper brown person with folded hands	ğŸ™ğŸ¾	True
snout	ğŸ½	True
black person raising both hands in celebration	ğŸ™ŒğŸ¿	True
white square button	ğŸ”³	True
sea	ğŸŒŠ	True
racquet	ğŸ¾	True
kitty	ğŸ±	True
flag for paraguay	ğŸ‡µğŸ‡¾	True
wash	ğŸ›	True
viewing	ğŸ‘	True
grandstand	ğŸŸ	True
orange ball	ğŸ€	True
cheeky monkey	ğŸ™ˆ	True
squeans	ğŸ’«	True
tropical drink	ğŸ¹	True
anger	ğŸ’¢	True
movie	ğŸ¬	True
phase	ğŸŒ›	True
oils	ğŸ¨	True
light brown face massage	ğŸ’†ğŸ¼	True
sign	â™Œï¸	True
porcelain	ğŸš¾	True
upwards black arrow	â¬†ï¸	True
movies	ğŸ¦	True
prince	ğŸ°	True
night with stars	ğŸŒƒ	True
scary face	ğŸ‘¹	True
water	â™’	True
flu	ğŸ˜·	True
decorate	ğŸ€	True
african leopard	ğŸ†	True
drum with drumsticks	ğŸ¤º	True
check	ğŸ›ƒ	True
books	ğŸ“š	True
winking	ğŸ˜‰	True
black	ğŸ¼	True
stars	â™‰	True
regional indicator symbol letters km	ğŸ‡°ğŸ‡²	True
nervous face	ğŸ˜°	True
flower	ğŸŒº	True
mandarin	ğŸŠ	True
nose	ğŸ‘ƒ	True
flirt	ğŸ˜	True
grimacing face	ğŸ˜¬	True
light brown nail polish	ğŸ’…ğŸ¼	True
octopus	ğŸ™	True
color	ğŸ‚	True
sleepy face	ğŸ˜ª	True
smiling	ğŸ˜…	True
breasts	ğŸ‘š	True
eat	ğŸ½	True
stability	ğŸ’™	True
ice	ğŸ§	True
part alternation mark	ã€½ï¸	True
africa	ğŸŒ	True
4th	ğŸ†	True
day	ğŸ	True
full	ğŸŒ	True
rice	ğŸ¶	True
slot	ğŸ°	True
mouthless	ğŸ˜¶	True
objective	ğŸ˜	True
pear	ğŸ	True
sports medal	ğŸ…	True
curled page	ğŸ“ƒ	True
tears	ğŸ˜¿	True
sow	ğŸ–	True
cross	âŒ	True
eight ball	ğŸ±	True
rofl	ğŸ¤£	True
no bikes sign	ğŸš³	True
side of police car	ğŸš“	True
turban	ğŸ‘³	True
travel	ğŸ›ƒ	True
team	ğŸœ	True
ball	ğŸŠ	True
ticket stub	ğŸ«	True
thorns	ğŸŒ¹	True
flag for caribbean netherlands	ğŸ‡§ğŸ‡¶	True
heavy minus sign	â–	True
autumn	ğŸƒ	True
kitchen knife	ğŸ”ª	True
black person with pouting face	ğŸ™ğŸ¿	True
bruneian flag	ğŸ‡§ğŸ‡³	True
flag for andorra	ğŸ‡¦ğŸ‡©	True
deeper brown person with blond hair	ğŸ‘±ğŸ¾	True
lithuanian flag	ğŸ‡±ğŸ‡¹	True
x	âŒ	True
cat face	ğŸ±	True
reward	ğŸ†	True
performance	ğŸ­	True
top hat	ğŸ©	True
cowgirl boots	ğŸ‘¢	True
rosette	ğŸµ	True
tongue	ğŸ˜›	True
statue of liberty	ğŸ—½	True
goofy	ğŸ˜‹	True
toast	ğŸ»	True
airlines	âœˆï¸	True
cross eyes face	ğŸ˜µ	True
silence	ğŸ˜¶	True
shroom	ğŸ„	True
travel	âœˆï¸	True
welcome	ğŸ	True
queen	ğŸ’‚	True
marina	âš“	True
pointing down	ğŸ‘‡	True
play	ğŸ²	True
flag for saudi arabia	ğŸ‡¸ğŸ‡¦	True
chequred	ğŸ	True
potassium	ğŸ 	True
hair flick	ğŸ’	True
frame with picture	ğŸ–¼	True
science	ğŸ”¬	True
popping corn	ğŸ¿	True
waste	ğŸš®	True
person with pouting face	ğŸ™	True
regional indicator symbol letters sg	ğŸ‡¸ğŸ‡¬	True
cue	ã€½ï¸	True
cute	ğŸ¥	True
scary clown	ğŸ¤¡	True
sky	ğŸŒš	True
hallelujah	ğŸ™Œ	True
mountain	â›°	True
middle school	ğŸ«	True
mask	ğŸ‘¹	True
music	ğŸ·	True
money	ğŸ’·	True
greek	â™Š	True
three button mouse	ğŸ–±	True
sky	ğŸŒ“	True
open hands sign	ğŸ‘	True
wool	ğŸ‘	True
centaur	â™ï¸	True
hollywood	ğŸ¥	True
bank branch	ğŸ¦	True
crescent	ğŸŒ™	True
rolling on the floor laughing	ğŸ¤£	True
ä¸­	ğŸ€„	True
peach	ğŸ‘	True
profile	ğŸ‘¤	True
blouse	ğŸ‘š	True
food	ğŸ‘…	True
hammer	ğŸ”¨	True
astrology	â™ï¸	True
home	ğŸŒ	True
new york	ğŸ•	True
light brown thumbs down sign	ğŸ‘ğŸ¼	True
leprechaun	ğŸŒˆ	True
cat	ğŸ˜¸	True
engagement	ğŸ‘°	True
night	ğŸŒ™	True
black flexed biceps	ğŸ’ªğŸ¿	True
regional indicator symbol letters mt	ğŸ‡²ğŸ‡¹	True
wrapped present	ğŸ	True
shopping bags	ğŸ›	True
nervous	ğŸ˜¬	True
faroe islander flag	ğŸ‡«ğŸ‡´	True
multiple musical notes	ğŸ¶	True
paperclip	ğŸ“	True
church	â›ª	True
winter	â„ï¸	True
banned	ğŸš«	True
stop	ğŸ‘	True
impartial	ğŸ˜	True
lady	ğŸ	True
regional indicator symbol letters so	ğŸ‡¸ğŸ‡´	True
cooking	ğŸ³	True
sake bottle and cup	ğŸ¶	True
croatian flag	ğŸ‡­ğŸ‡·	True
zodiac	â™‘ï¸	True
jolly	ğŸ…	True
reproduction	ğŸ‡	True
flag for zimbabwe	ğŸ‡¿ğŸ‡¼	True
fall leaves	ğŸ‚	True
deeper brown information desk person	ğŸ’ğŸ¾	True
drink	ğŸ¶	True
staff	ğŸ¼	True
seaweed	ğŸ˜	True
shortcake	ğŸ°	True
perfect	ğŸ’¯	True
timer clock	â²	True
laughing	ğŸ˜‚	True
relieved face	ğŸ˜Œ	True
silent mode	ğŸ“³	True
flag for french southern territories	ğŸ‡¹ğŸ‡«	True
light brown white left pointing backhand index	ğŸ‘ˆğŸ¼	True
trust	ğŸ’™	True
friend	ğŸ•	True
peace	âœŒï¸	True
girl with tiara	ğŸ‘¸	True
light brown guardsman	ğŸ’‚ğŸ¼	True
moon	ğŸŒ—	True
money	ğŸ’´	True
north west arrow	â†–ï¸	True
vhs	ğŸ“¼	True
waning	ğŸŒ˜	True
dressed	ğŸ‘š	True
light brown bride with veil	ğŸ‘°ğŸ¼	True
pink	ğŸ½	True
numeric input	ğŸ”¢	True
fairground	ğŸ¡	True
traffic	ğŸš¦	True
group	ğŸ‘ª	True
rock on	ğŸ¤˜	True
maple leaf	ğŸ	True
bikini	ğŸ‘™	True
thumbs down	ğŸ‘	True
screaming cat	ğŸ™€	True
water fountain	â›²	True
car	ğŸš•	True
ocean	ğŸ„	True
street	ğŸš¸	True
train	ğŸšˆ	True
white face with ok gesture	ğŸ™†ğŸ»	True
system card	ğŸ“‡	True
compression	ğŸ—œ	True
kosovar flag	ğŸ‡½ğŸ‡°	True
icecream	ğŸ¨	True
deeper brown raised fist	âœŠğŸ¾	True
melody	ğŸ¶	True
red circle crossed	ğŸš«	True
cute bear	ğŸ»	True
regional indicator symbol letters ch	ğŸ‡¨ğŸ‡­	True
goods	ğŸ›ƒ	True
green	ğŸ’š	True
leaves	ğŸŒ³	True
radio	ğŸ“»	True
monkey head	ğŸµ	True
olive toned white right pointing backhand index	ğŸ‘‰ğŸ½	True
flag for hungary	ğŸ‡­ğŸ‡º	True
royalty	ğŸ‘¸	True
tongue	ğŸ˜	True
regional indicator symbol letters zw	ğŸ‡¿ğŸ‡¼	True
penguin	ğŸ§	True
blowing kiss	ğŸ˜˜	True
honest	ğŸ’›	True
email	ğŸ“§	True
croissant	ğŸ¥	True
wide eyes	ğŸ‘€	True
greek	â™‘	True
door	ğŸšª	True
fuel pump	â›½	True
woman	ğŸ£	True
education	ğŸ“	True
streamers	ğŸ	True
frog	ğŸ¸	True
kid	ğŸ	True
grinning face	ğŸ˜ƒ	True
heart	ğŸ˜š	True
flag for gibraltar	ğŸ‡¬ğŸ‡®	True
open book	ğŸ“–	True
ball	ğŸˆ	True
fruit	ğŸ	True
bus	ğŸš	True
frowning face with open mouth	ğŸ˜¦	True
duck face	ğŸ˜—	True
train	ğŸš‹	True
lips	ğŸ˜˜	True
show	ğŸ†	True
hamster face	ğŸ¹	True
small	ğŸš¼	True
regional indicator symbol letters au	ğŸ‡¦ğŸ‡º	True
palm tree	ğŸŒ´	True
regional indicator symbol letters nl	ğŸ‡³ğŸ‡±	True
flag for new caledonia	ğŸ‡³ğŸ‡¨	True
black fisted hand sign	ğŸ‘ŠğŸ¿	True
purple vegetable	ğŸ†	True
temple	ğŸ•	True
greek	â™Œ	True
bullet	ğŸš„	True
suspension	ğŸšŸ	True
doughnut	ğŸ©	True
white medium star	â­ï¸	True
wish	ğŸ‚	True
somber	ğŸ˜­	True
duty	ğŸ’œ	True
park	ğŸ¡	True
motor boat	ğŸ›¥	True
front of car	ğŸš˜	True
micro	ğŸº	True
bulb	ğŸŒ·	True
stop	ğŸš¥	True
goblin	ğŸ‘º	True
dancing	ğŸ’ƒ	True
quarter	ğŸŒ“	True
fog	ğŸŒ	True
card	ğŸ´	True
headwear	ğŸ‘³	True
white guardsman	ğŸ’‚ğŸ»	True
rocket	ğŸš€	True
lying face	ğŸ¤¥	True
hospital	ğŸ©	True
knife and fork	ğŸ´	True
black ok hand sign	ğŸ‘ŒğŸ¿	True
lion face	ğŸ¦	True
bearer	â™’ï¸	True
face with ok gesture	ğŸ™†	True
sleep	ğŸ˜´	True
cake	ğŸ¥	True
casino	ğŸ°	True
heavy dollar sign	ğŸ’²	True
secret	â˜ï¸	True
flag for mayotte	ğŸ‡¾ğŸ‡¹	True
baby	ğŸ¤	True
flag for great britain	ğŸ‡¬ğŸ‡§	True
unimpressed	ğŸ˜’	True
cute boy	ğŸ™‡	True
white pedestrian	ğŸš¶ğŸ»	True
mother christmas	ğŸ¤¶	True
regional indicator symbol letters kr	ğŸ‡°ğŸ‡·	True
school	ğŸ	True
tub	ğŸ›	True
white medium star	â­	True
adorable	ğŸ’ 	True
pure	ğŸš°	True
hovering man	ğŸ•´	True
greek	â™	True
romance	â¤ï¸	True
black raised fist	âœŠğŸ¿	True
flag for burkina faso	ğŸ‡§ğŸ‡«	True
olive toned police officer	ğŸ‘®ğŸ½	True
smiley face	â˜ºï¸	True
flower	ğŸŒ¹	True
clip	ğŸ©	True
white raised hand	âœ‹ğŸ»	True
rain	â˜”	True
british	ğŸ’·	True
royalty	ğŸ¯	True
deeper brown construction worker	ğŸ‘·ğŸ¾	True
church	â›ªï¸	True
end	ğŸ	True
gift box	ğŸ’	True
house buildings	ğŸ˜	True
lovers	ğŸ’	True
cloud with tornado	ğŸŒª	True
horse	ğŸ‡	True
pointing left	ğŸ‘ˆ	True
aerial	ğŸš¡	True
light brown mountain bicyclist	ğŸšµğŸ¼	True
constellation	â™	True
squid	ğŸ™	True
independence	ğŸ†	True
carp streamer	ğŸ	True
diamond shape with a dot inside	ğŸ’ 	True
keycap digit two	2âƒ£ï¸	True
frustrated	ğŸ˜°	True
applause	ğŸ‘	True
sign	ğŸ‘	True
regional indicator symbol letters ye	ğŸ‡¾ğŸ‡ª	True
ramen	ğŸ¥	True
slow	ğŸš¸	True
robot face	ğŸ¤–	True
flag for puerto rico	ğŸ‡µğŸ‡·	True
no smartphones	ğŸ“µ	True
movie	ğŸ¦	True
zip it	ğŸ¤	True
train	ğŸš…	True
waxing	ğŸŒ™	True
flag for chile	ğŸ‡¨ğŸ‡±	True
designer	ğŸ‘–	True
bath	ğŸ›	True
rail	ğŸš 	True
console controller	ğŸ®	True
flag for thailand	ğŸ‡¹ğŸ‡­	True
service	ğŸš–	True
steam	ğŸ’¨	True
fair	ğŸ¢	True
flag for palau	ğŸ‡µğŸ‡¼	True
woman frowning	ğŸ™	True
punch	ğŸ¹	True
astrology	â™’	True
star	ğŸŒƒ	True
tanabata tree	ğŸ‹	True
flag for malta	ğŸ‡²ğŸ‡¹	True
place	ğŸ†	True
regional indicator symbol letters tr	ğŸ‡¹ğŸ‡·	True
music	ğŸ’ƒ	True
red cross	ğŸ¥	True
regional indicator symbol letters fo	ğŸ‡«ğŸ‡´	True
porcelain	ğŸš½	True
smile	ğŸ˜¸	True
stronghold	ğŸ°	True
present	ğŸ	True
sailor	âš“ï¸	True
biscuit	ğŸª	True
vexed	ğŸ˜ 	True
color	ğŸŒˆ	True
squared cl	ğŸ†‘	True
flag for nigeria	ğŸ‡³ğŸ‡¬	True
blood test	ğŸ’‰	True
green heart	ğŸ’š	True
beverage	ğŸµ	True
round of applause	ğŸ‘	True
visa	ğŸ’³	True
regional indicator symbol letters ro	ğŸ‡·ğŸ‡´	True
clock	â°	True
traffic light	ğŸš¦	True
light brown man with turban	ğŸ‘³ğŸ¼	True
olive toned flexed biceps	ğŸ’ªğŸ½	True
desert	ğŸ«	True
boo	ğŸ‘	True
currency	ğŸ’¶	True
clock face five oclock	ğŸ•”	True
flags	ğŸ	True
sorrow	ğŸ™	True
drugs	ğŸ’Š	True
waxing gibbous moon symbol	ğŸŒ”	True
tongue	ğŸ‘…	True
soap	ğŸ›€	True
heart hospital	ğŸ©	True
dairy cow	ğŸ„	True
chipmunk	ğŸ¿	True
keycap digit six	6âƒ£ï¸	True
white thumbs down sign	ğŸ‘ğŸ»	True
virgo	â™	True
blue heart	ğŸ’™	True
flag for cocos islands	ğŸ‡¨ğŸ‡¨	True
football	ğŸˆ	True
nicotine	ğŸš­	True
grandma	ğŸ‘	True
float	ğŸƒ	True
curry and rice	ğŸ›	True
night	ğŸŒ†	True
husk	ğŸŒ½	True
flag for tanzania	ğŸ‡¹ğŸ‡¿	True
playfulness	ğŸ‘…	True
elsa	â„ï¸	True
payday	ğŸ§	True
diaphoresis	ğŸ˜“	True
runner	ğŸ‘Ÿ	True
tetraodontidae	ğŸ¡	True
skiing	ğŸ¿	True
lantern	ğŸ®	True
motor scooter	ğŸ›µ	True
baby	ğŸš¼	True
cutting hair	ğŸ’‡	True
christmas island flag	ğŸ‡¨ğŸ‡½	True
å–¶	ğŸˆº	True
depressed	ğŸ˜’	True
sun behind cloud	â›…	True
fast envelope	ğŸ“¨	True
coca	ğŸ«	True
skull and crossbones	â˜ 	True
passenger train	ğŸš†	True
spring	ğŸŒ±	True
package	ğŸšš	True
baby chick	ğŸ¤	True
entertainment	ğŸ¡	True
pointing right	ğŸ‘‰	True
bathroom	ğŸ›	True
regional indicator symbol letters ni	ğŸ‡³ğŸ‡®	True
dom rep flag	ğŸ‡©ğŸ‡´	True
crime	ğŸš”	True
dairy	ğŸ„	True
injured	ğŸ¤•	True
runner	ğŸƒ	True
leisure	ğŸ©	True
eyeglasses	ğŸ‘“	True
family of two women with two boys	ğŸ‘©â€ğŸ‘©â€ğŸ‘¦â€ğŸ‘¦	True
shaved ice	ğŸ§	True
rock on	ğŸ‘	True
wave	ğŸ„	True
sky	ğŸŒ›	True
dung	ğŸ’©	True
regional indicator symbol letters gq	ğŸ‡¬ğŸ‡¶	True
picture	ğŸ¥	True
smoke	ğŸ‘Œ	True
regional indicator symbol letters cy	ğŸ‡¨ğŸ‡¾	True
abandoned house	ğŸš	True
lips	ğŸ˜—	True
regional indicator symbol letters nc	ğŸ‡³ğŸ‡¨	True
spring	ğŸƒ	True
8 ball	ğŸ±	True
rice cracker	ğŸ˜	True
shallow pan of food	ğŸ¥˜	True
monster	ğŸŒ•	True
jesus	ğŸ„	True
heart	ğŸ˜	True
bungalow	ğŸ 	True
tea	ğŸµ	True
cool	ğŸ˜	True
kitten	ğŸˆ	True
approval	ğŸ‘	True
art	ğŸ¨	True
video	ğŸ¥	True
squirrel	ğŸ¿	True
refract	ğŸŒˆ	True
mongolian flag	ğŸ‡²ğŸ‡³	True
chocolate box	ğŸ’	True
snow capped mountain	ğŸ”	True
smooth	ğŸ˜	True
keycap digit eight	8ï¸âƒ£	True
sick	ğŸ¤’	True
flag for bouvet island	ğŸ‡§ğŸ‡»	True
flag for canary islands	ğŸ‡®ğŸ‡¨	True
beer mug	ğŸº	True
cute	ğŸ™	True
lick	ğŸ‘…	True
nose	ğŸ½	True
regional indicator symbol letter s	ğŸ‡¸	True
phase	ğŸŒœ	True
banana	ğŸ’	True
ballerina	ğŸ™†	True
scorpion	â™ï¸	True
black girl	ğŸ‘§ğŸ¿	True
airplane	âœˆï¸	True
serve	ğŸ¦	True
detective	ğŸ•µ	True
man	ğŸš»	True
black man with gua pi mao	ğŸ‘²ğŸ¿	True
sweat	ğŸ˜“	True
face with tears of joy	ğŸ˜‚	True
united states	ğŸ’µ	True
libra	â™ï¸	True
pout	ğŸ˜¦	True
sun	â˜€ï¸	True
regional indicator symbol letters bo	ğŸ‡§ğŸ‡´	True
kermit	ğŸ¸	True
olive toned face with no good gesture	ğŸ™…ğŸ½	True
clock face seven oclock	ğŸ•–	True
first	ğŸ†	True
black question mark ornament	â“	True
rail	ğŸš	True
flag for clipperton island	ğŸ‡¨ğŸ‡µ	True
cold	ğŸ¨	True
bald eagle	ğŸ¦…	True
sign	â™ï¸	True
net	ğŸ¾	True
post	ğŸš©	True
ac adaptor	ğŸ”Œ	True
mansion	ğŸ 	True
serpent	â›	True
meditate	ğŸ˜”	True
mixed	ğŸ¸	True
happy person raising one hand	ğŸ™‹	True
rice	ğŸ‘	True
emphasis	ğŸ’¥	True
campsite	ğŸ•	True
flag for gabon	ğŸ‡¬ğŸ‡¦	True
start	ğŸŒ±	True
dressing gown	ğŸ‘˜	True
deeper brown person bowing deeply	ğŸ™‡ğŸ¾	True
å¾—	ğŸ‰	True
anthropomorphic	ğŸŒ	True
steam locomotive	ğŸš‚	True
ball	ğŸ™	True
saint	ğŸ€	True
monkey	ğŸ’	True
prawn	ğŸ¤	True
earth	ğŸŒ	True
gas	ğŸˆ	True
italian flag	ğŸ‡®ğŸ‡¹	True
closed mailbox with raised flag	ğŸ“«	True
curly page	ğŸ“ƒ	True
swimmer	ğŸŠ	True
steady	ğŸ¢	True
anthropomorphic	ğŸŒ›	True
flying	âœˆï¸	True
bunny	ğŸ‘¯	True
swimming	ğŸŠ	True
sunny	ğŸ˜	True
globe	ğŸŒ	True
european	ğŸ°	True
clapboard	ğŸ¬	True
handbag	ğŸ‘›	True
not	ğŸ™…	True
field hockey	ğŸ‘	True
sand	ğŸš	True
molester moon	ğŸŒš	True
flag for uganda	ğŸ‡ºğŸ‡¬	True
silly	ğŸ˜	True
evergreen	ğŸŒ²	True
flashlight	ğŸ”¦	True
denim	ğŸ‘–	True
scared	ğŸƒ	True
canvas	ğŸª	True
wednesday	ğŸª	True
constellation	â™Œ	True
hole	ğŸ•³	True
flag for western sahara	ğŸ‡ªğŸ‡­	True
regional indicator symbol letter z	ğŸ‡¿	True
business shirt	ğŸ‘”	True
maiden	â™ï¸	True
virus	ğŸ˜·	True
flag for finland	ğŸ‡«ğŸ‡®	True
morning	ğŸŒ…	True
black clapping hands sign	ğŸ‘ğŸ¿	True
wine	ğŸ¶	True
rail	ğŸš	True
maiden	â™	True
birth	ğŸ©	True
flag for uruguay	ğŸ‡ºğŸ‡¾	True
japanese	ğŸ	True
green leaves	ğŸƒ	True
irish flag	ğŸ‡®ğŸ‡ª	True
movie	ğŸ¥	True
puckered	ğŸ˜½	True
steam	ğŸ˜¤	True
family of a man and woman with two girls	ğŸ‘¨â€ğŸ‘©â€ğŸ‘§â€ğŸ‘§	True
japanese	ğŸ¡	True
fisherman	âš“	True
kernel	ğŸŒ½	True
glower	ğŸ˜¾	True
grinning cat face with smiling eyes	ğŸ˜¸	True
pig face	ğŸ·	True
magnifying glass	ğŸ”	True
olive toned happy person raising one hand	ğŸ™‹ğŸ½	True
olive toned white up pointing backhand index	ğŸ‘†ğŸ½	True
clean	ğŸ›€	True
meat on bone	ğŸ–	True
unique	â„ï¸	True
knife weapon	ğŸ—¡	True
mahjong tile red dragon	ğŸ€„ï¸	True
pregnant lady	ğŸ¤°	True
puppy paw prints	ğŸ¾	True
deeper brown princess	ğŸ‘¸ğŸ¾	True
japanese post office	ğŸ£	True
information desk person	ğŸ’	True
residence	ğŸ¯	True
forbid	ğŸˆ²	True
water	ğŸª	True
thunder cloud and rain	â›ˆ	True
duck	ğŸ¦†	True
waning crescent moon symbol	ğŸŒ˜	True
dress	ğŸ‘—	True
milk	ğŸ¼	True
triangle ruler	ğŸ“	True
tasty	ğŸ˜‹	True
deeper brown girl	ğŸ‘§ğŸ¾	True
travel	ğŸ’	True
flag for india	ğŸ‡®ğŸ‡³	True
bank	ğŸ¦	True
constellation	â™ï¸	True
no	ğŸ‘	True
black police officer	ğŸ‘®ğŸ¿	True
devil	ğŸ˜ˆ	True
regional indicator symbol letters mq	ğŸ‡²ğŸ‡¶	True
mantelpiece clock	ğŸ•°	True
easter	ğŸŒ·	True
high five	âœ‹	True
sign	â™ï¸	True
sobbing	ğŸ˜­	True
whistling	ğŸ˜—	True
archer	â™ï¸	True
kikazaru	ğŸ™‰	True
observation wheel	ğŸ¡	True
moon	ğŸ´	True
snake	â›	True
drought	ğŸŒµ	True
android	ğŸ“±	True
wings	ğŸ’¸	True
marina	âš“ï¸	True
scorpion	â™	True
military decoration	ğŸ–	True
hot bath	ğŸ›€	True
customs	ğŸ›ƒ	True
deeper brown surfer	ğŸ„ğŸ¾	True
flag for tristan da cunha	ğŸ‡¹ğŸ‡¦	True
male	ğŸš¹	True
score	ğŸ¼	True
speaking head in silhouette	ğŸ—£	True
white baby angel	ğŸ‘¼ğŸ»	True
trouble	ğŸ˜ˆ	True
flag for papua new guinea	ğŸ‡µğŸ‡¬	True
transportation	ğŸš	True
down arrow envelope	ğŸ“©	True
police	ğŸš”	True
clef	ğŸ¼	True
et	ğŸ‘½	True
regional indicator symbol letters ie	ğŸ‡®ğŸ‡ª	True
spacecraft	ğŸš€	True
centipede	ğŸ›	True
bear	ğŸ¯	True
ok	ğŸ†—	True
spirits	ğŸ	True
celebration	ğŸ‰	True
small orange diamond	ğŸ”¸	True
joker card	ğŸƒ	True
daze	ğŸ˜•	True
diamond ring	ğŸ’	True
compete	ğŸ½	True
lower left ballpoint pen	ğŸ–Š	True
ghost	ğŸ‘»	True
identification	ğŸ›‚	True
light	ğŸš¨	True
hot pepper	ğŸŒ¶	True
mountain	ğŸš 	True
smoking	ğŸ‘Œ	True
content	ğŸ˜Œ	True
years	ğŸ	True
light brown ear	ğŸ‘‚ğŸ¼	True
grumpy face	ğŸ˜ 	True
playing card black joker	ğŸƒ	True
regional indicator symbol letters ci	ğŸ‡¨ğŸ‡®	True
moonface	ğŸŒ	True
mustache	ğŸ‘º	True
deciduous tree	ğŸŒ³	True
light	ğŸšˆ	True
grinning	ğŸ˜€	True
lady cow	ğŸ	True
martiniquais flag	ğŸ‡²ğŸ‡¶	True
gherkin	ğŸ¥’	True
water polo	ğŸ¤¾	True
bugle	ğŸ“¯	True
stars	â™ï¸	True
no mobile phones	ğŸ“µ	True
blank look	ğŸ™	True
fortress	ğŸ°	True
pineapple	ğŸ¹	True
kids	ğŸš¸	True
suspension railway	ğŸšŸ	True
regional indicator symbol letters af	ğŸ‡¦ğŸ‡«	True
carp	ğŸ	True
restroom	ğŸš¹	True
grinning face	ğŸ˜€	True
sad	ğŸ˜¢	True
walker	ğŸš¶	True
mute volume	ğŸ”‡	True
gesture	ğŸ‘	True
cold	â„ï¸	True
face	ğŸŒœ	True
information	ğŸ’¾	True
metropolitan	ğŸŒ‡	True
rhinoceros	ğŸ¦	True
league	ğŸ‰	True
white smiling face	â˜ºï¸	True
tongue	ğŸ˜œ	True
flag for united states	ğŸ‡ºğŸ‡¸	True
ireland	ğŸ€	True
postal horn	ğŸ“¯	True
i am a witness	ğŸ‘â€ğŸ—¨	True
admiralty pattern anchor	âš“	True
fortune	ğŸ	True
gridiron	ğŸˆ	True
sad	ğŸ˜Ÿ	True
alien	ğŸ˜±	True
star	ğŸŒŒ	True
hush	ğŸ˜¯	True
crossed swords	âš”	True
race	ğŸ	True
marshallese flag	ğŸ‡²ğŸ‡­	True
kissy face	ğŸ˜š	True
vinegar	ğŸ‡	True
avatar	ğŸ‘¤	True
regional indicator symbol letters sb	ğŸ‡¸ğŸ‡§	True
regional indicator symbol letters hn	ğŸ‡­ğŸ‡³	True
piano	ğŸ¹	True
light brown older woman	ğŸ‘µğŸ¼	True
tumbler glass	ğŸ¥ƒ	True
truck	ğŸšš	True
olive toned nail polish	ğŸ’…ğŸ½	True
slow	ğŸŒ	True
cosmonaut	ğŸš€	True
no	ğŸ™…	True
flag for solomon islands	ğŸ‡¸ğŸ‡§	True
regional indicator symbol letters uy	ğŸ‡ºğŸ‡¾	True
orange star	âœ´ï¸	True
cinema	ğŸ¦	True
worried	ğŸ˜“	True
transport	ğŸšŠ	True
regional indicator symbol letters ba	ğŸ‡§ğŸ‡¦	True
concierge	ğŸ’	True
snowboard	ğŸ‚	True
dollar sign eyes	ğŸ¤‘	True
discouraged	ğŸ˜	True
sheep	ğŸ	True
foot guard	ğŸ’‚	True
taxi	ğŸš•	True
regional indicator symbol letters tj	ğŸ‡¹ğŸ‡¯	True
chart with upwards trend and yen sign	ğŸ’¹	True
moisture	ğŸ’§	True
stew	ğŸ¢	True
king	ğŸ‘‘	True
keycap digit six	6ï¸âƒ£	True
exit	ğŸšª	True
cook	ğŸ³	True
fruit	ğŸ‡	True
bowl of rice	ğŸš	True
cricket bat and ball	ğŸ	True
fearful face	ğŸ˜¨	True
praying hands	ğŸ™	True
blurry	ğŸ‘“	True
backpack	ğŸ’	True
mouth	ğŸ˜®	True
food	ğŸŒ°	True
london	ğŸ©	True
up	ğŸ†™	True
french horn	ğŸ“¯	True
dislike	ğŸ‘	True
legendary	ğŸ‰	True
fries	ğŸŸ	True
musical	ğŸ¼	True
stopwatch	â±	True
twins	â™Š	True
vcr	ğŸ“¼	True
regional indicator symbol letters mx	ğŸ‡²ğŸ‡½	True
granny	ğŸ	True
radioactive sign	â˜¢	True
heart face	ğŸ˜	True
bento	ğŸ±	True
dog	ğŸ©	True
mountain bike	ğŸšµ	True
topper	ğŸ©	True
blood donation	ğŸ’‰	True
fried	ğŸ—	True
flag for kazakhstan	ğŸ‡°ğŸ‡¿	True
wrap	ğŸ	True
romance	ğŸŒ¹	True
fountain	â›²	True
regional indicator symbol letters gf	ğŸ‡¬ğŸ‡«	True
smug face	ğŸ˜	True
scary	ğŸƒ	True
round pushpin	ğŸ“	True
confounded face	ğŸ˜–	True
july	ğŸ†	True
nonplussed	ğŸ˜•	True
archery	ğŸ¯	True
backstroke	ğŸŠ	True
satellite antenna	ğŸ“¡	True
regional indicator symbol letters my	ğŸ‡²ğŸ‡¾	True
idaho	ğŸŸ	True
demon	ğŸ‘º	True
morn	ğŸ˜­	True
straight ruler	ğŸ“	True
railway carriage	ğŸšƒ	True
laughing tears	ğŸ˜‚	True
squared cool	ğŸ†’	True
police car	ğŸš“	True
black face with no good gesture	ğŸ™…ğŸ¿	True
run	ğŸƒ	True
rowing	ğŸš£	True
black older man	ğŸ‘´ğŸ¿	True
negative squared latin capital letter p	ğŸ…¿ï¸	True
fork	ğŸ´	True
map of japan	ğŸ—¾	True
emperor	ğŸ	True
pepperoni pizza	ğŸ•	True
sparkle	â‡ï¸	True
flag for lebanon	ğŸ‡±ğŸ‡§	True
middle	ğŸ«	True
paint	ğŸ¨	True
tongue out	ğŸ˜	True
kissing lips	ğŸ’‹	True
quiet	ğŸ˜¯	True
zodiac	â™‰	True
empire apple	ğŸ	True
father	ğŸ‘ª	True
mountain	ğŸšµ	True
sandals	ğŸ‘¡	True
mummy	ğŸ‘³	True
american dollar	ğŸ’µ	True
white thumbs up sign	ğŸ‘ğŸ»	True
h20	ğŸš°	True
æŒ‡	ğŸˆ¯	True
grapes	ğŸ·	True
videocassette	ğŸ“¼	True
smirking face	ğŸ˜	True
regional indicator symbol letters np	ğŸ‡³ğŸ‡µ	True
deeper brown clapping hands sign	ğŸ‘ğŸ¾	True
stove	ğŸ©	True
moon	ğŸŒ‘	True
grade	ğŸ’®	True
knife	ğŸ´	True
ceremony	ğŸ“	True
contacts	ğŸ‘“	True
man with gua pi mao	ğŸ‘²	True
blown	ğŸ’¸	True
moon viewing ceremony	ğŸ‘	True
mask	ğŸ­	True
horse face	ğŸ´	True
theater	ğŸ¦	True
cable	ğŸš 	True
medallion	ğŸ–	True
flag for central african republic	ğŸ‡¨ğŸ‡«	True
light brown haircut	ğŸ’‡ğŸ¼	True
bunny rabbit	ğŸ°	True
shaved	ğŸ§	True
obento	ğŸ±	True
white happy person raising one hand	ğŸ™‹ğŸ»	True
suitcase	ğŸ’¼	True
clown face	ğŸ¤¡	True
rainbow	ğŸŒˆ	True
bolt	ğŸ”©	True
cupid arrow	ğŸ’˜	True
shampoo	ğŸ›	True
basketball	ğŸ€	True
flag for guatemala	ğŸ‡¬ğŸ‡¹	True
voice	ğŸ¤	True
score	ğŸ’®	True
face with rolling eyes	ğŸ™„	True
sex	ğŸª	True
passport control	ğŸ›‚	True
solar eclipse	ğŸŒ‘	True
city sunset	ğŸŒ‡	True
swim	ğŸŠ	True
relationship	ğŸ‘¥	True
diesel train	ğŸš†	True
game	ğŸ¯	True
regional indicator symbol letters cu	ğŸ‡¨ğŸ‡º	True
swimsuit	ğŸ‘™	True
teacup without handle	ğŸµ	True
regional indicator symbol letters la	ğŸ‡±ğŸ‡¦	True
praise hands	ğŸ™Œ	True
fry	ğŸ³	True
clap	ğŸ‘	True
black construction worker	ğŸ‘·ğŸ¿	True
flag for jamaica	ğŸ‡¯ğŸ‡²	True
wilted flower	ğŸ¥€	True
kissy face	ğŸ˜—	True
no phones	ğŸ“µ	True
piece of cake	ğŸ°	True
food	ğŸŒ½	True
heartbeat	ğŸ’“	True
dusk	ğŸŒ†	True
passenger ship	ğŸ›³	True
tanabata	ğŸ‹	True
astrology	â™‰ï¸	True
flag for bhutan	ğŸ‡§ğŸ‡¹	True
hive	ğŸ	True
intelligence	ğŸ’®	True
norwegian flag	ğŸ‡³ğŸ‡´	True
okay	ğŸ‘Œ	True
constellation	â™“	True
exclamation question mark	â‰ï¸	True
smiling	ğŸ˜	True
smiling face with sunglasses	ğŸ˜	True
police	ğŸš“	True
bathroom	ğŸš¿	True
on	ğŸ”›	True
lower left fountain pen	ğŸ–‹	True
fluttering	ğŸƒ	True
deeper brown ok hand sign	ğŸ‘ŒğŸ¾	True
hat	ğŸ©	True
spooky	ğŸŒ	True
postbox	ğŸ“®	True
flag for philippines	ğŸ‡µğŸ‡­	True
winners trophy	ğŸ†	True
zodiac	â™“	True
constellation	â™Šï¸	True
man	ğŸ‘¨	True
seafood	ğŸ¤	True
nope	ğŸ™…	True
wind bell	ğŸ	True
cold	ğŸ˜“	True
gift	ğŸ’¸	True
purple devil	ğŸ˜ˆ	True
burger	ğŸ”	True
alcohol	ğŸ®	True
currency	ğŸ’´	True
without expression	ğŸ˜‘	True
here	ğŸˆ	True
white down pointing backhand index	ğŸ‘‡	True
show	ğŸ«	True
glower	ğŸ˜¦	True
crop	ğŸŒ¾	True
closed book	ğŸ“•	True
dairy	ğŸ¦	True
open file folder	ğŸ“‚	True
phase	ğŸŒ’	True
snarky	ğŸ’	True
new york	ğŸ—½	True
policeman	ğŸ‘®	True
distress	ğŸ˜§	True
constellation	â™‘	True
woman	ğŸšº	True
regional indicator symbol letters ar	ğŸ‡¦ğŸ‡·	True
fire	ğŸš’	True
potato	ğŸ 	True
world map	ğŸ—º	True
heart	â¤ï¸	True
bar	ğŸ¸	True
yellow	ğŸ’›	True
police	ğŸ©	True
moon	ğŸŒ“	True
foot	ğŸš¶	True
flag for italy	ğŸ‡®ğŸ‡¹	True
regional indicator symbol letters sx	ğŸ‡¸ğŸ‡½	True
eggplant	ğŸ†	True
selfless	ğŸ’›	True
vase	ğŸº	True
tropical	ğŸŒ´	True
train	ğŸš‚	True
purple devil	ğŸ‘¿	True
emergency	ğŸš”	True
black older woman	ğŸ‘µğŸ¿	True
helo	ğŸš	True
fairground	ğŸ 	True
black raised hand with part between middle and ring fingers	ğŸ––ğŸ¿	True
medal	ğŸ†	True
keyboard	ğŸ¹	True
ice cream	ğŸ¨	True
zodiac	â™‹	True
rollercoaster	ğŸ¢	True
picture frame	ğŸ–¼	True
homework	ğŸ’®	True
exhausted	ğŸ™€	True
bamboo	ğŸ¼	True
win	ğŸ†	True
shocked	ğŸ˜²	True
smile	ğŸ˜	True
fist bump	ğŸ‘Š	True
free	ğŸ†“	True
trolleybus	ğŸš	True
blubber	ğŸ‹	True
dizzy face	ğŸ˜µ	True
imac	ğŸ–¥	True
sad	ğŸ˜¿	True
green apple	ğŸ	True
loaf	ğŸ	True
popper	ğŸ‰	True
food	ğŸ˜‹	True
bk	ğŸ¦	True
hanafuda	ğŸ´	True
shirt	ğŸ½	True
hearts	â™¥ï¸	True
stars	â™’	True
baby	ğŸ¥	True
ear of maize	ğŸŒ½	True
regional indicator symbol letters rs	ğŸ‡·ğŸ‡¸	True
greek	â™‰	True
asian camel	ğŸ«	True
fortress	ğŸ¯	True
dog	ğŸ¾	True
anthropomorphic	ğŸŒš	True
net	ğŸ€	True
builder	ğŸ‘·	True
golden delicious apple	ğŸ	True
circled ideograph accept	ğŸ‰‘	True
olive toned raised hand	âœ‹ğŸ½	True
shame	ğŸ˜³	True
caterpillar	ğŸ›	True
rooster	ğŸ“	True
peace symbol	â˜®	True
lather	ğŸš¿	True
confident	ğŸ˜¼	True
trust	ğŸ’›	True
black white left pointing backhand index	ğŸ‘ˆğŸ¿	True
greek	â™‹	True
mask	ğŸ‘º	True
fried	ğŸ©	True
cluster	ğŸ‡	True
zodiac	â™Š	True
fido	ğŸ•	True
cracker	ğŸ˜	True
single eye	ğŸ‘	True
bovine	ğŸƒ	True
regional indicator symbol letters sl	ğŸ‡¸ğŸ‡±	True
carrot	ğŸ¥•	True
closed mailbox with lowered flag	ğŸ“ª	True
astrology	â™“	True
rice	ğŸ˜	True
flag for kiribati	ğŸ‡°ğŸ‡®	True
dog face	ğŸ¶	True
flag for ireland	ğŸ‡®ğŸ‡ª	True
rock	ğŸ¸	True
regional indicator symbol letters tv	ğŸ‡¹ğŸ‡»	True
sunglasses	ğŸ˜	True
naruto	ğŸ¥	True
flush	ğŸš½	True
sugar	ğŸ­	True
creepy moon	ğŸŒš	True
fish cake with swirl design	ğŸ¥	True
snooker	ğŸ±	True
sadface	ğŸ˜Ÿ	True
olive toned mountain bicyclist	ğŸšµğŸ½	True
regional indicator symbol letters sm	ğŸ‡¸ğŸ‡²	True
sneezing face	ğŸ¤§	True
moon	ğŸŒ–	True
bedroom	ğŸ›	True
hurricane	ğŸŒ€	True
deposit	ğŸ§	True
flag for bangladesh	ğŸ‡§ğŸ‡©	True
intoxicated	ğŸ’«	True
gay	ğŸ‘­	True
end with leftwards arrow above	ğŸ”š	True
daughter	ğŸ‘¸	True
black medium square	â—¼ï¸	True
greek	â™ï¸	True
flirting	ğŸ˜	True
increase volume	ğŸ”Š	True
car	ğŸš—	True
red delicious apple	ğŸ	True
butt	ğŸ‘	True
investigator	ğŸ”	True
side of car	ğŸš—	True
paddle	ğŸš£	True
dark heart	ğŸ–¤	True
unity	ğŸ‘­	True
phase	ğŸŒ—	True
flag for burundi	ğŸ‡§ğŸ‡®	True
crooked	ğŸ€	True
pound	ğŸ’·	True
ball	ğŸ‰	True
clock face eleven oclock	ğŸ•š	True
russian flag	ğŸ‡·ğŸ‡º	True
flag for pitcairn islands	ğŸ‡µğŸ‡³	True
checkered flag	ğŸ	True
sun behind cloud	â›…ï¸	True
red devil	ğŸ˜ˆ	True
olive toned swimmer	ğŸŠğŸ½	True
flower	ğŸŒ¸	True
mahjong tile red dragon	ğŸ€„	True
train	ğŸšƒ	True
open mailbox with lowered flag	ğŸ“­	True
japanese	ğŸ’ 	True
no cell phones	ğŸ“µ	True
stars	â™	True
sleuth	ğŸ•µ	True
dagger knife	ğŸ—¡	True
circled ideograph secret	ãŠ™ï¸	True
regional indicator symbol letters fj	ğŸ‡«ğŸ‡¯	True
brass	ğŸº	True
air quotes	âœŒï¸	True
collision	ğŸ’¥	True
summer	ğŸ”†	True
space	ğŸŒ	True
kissing face	ğŸ˜—	True
atom symbol	âš›	True
musical note	ğŸµ	True
chime	ğŸ	True
zodiac	â™ˆ	True
blank	ğŸ˜	True
flag for norway	ğŸ‡³ğŸ‡´	True
men	ğŸ‘¬	True
silhouette of japan	ğŸ—¾	True
paper	ğŸ’µ	True
lock and key	ğŸ”	True
tense	ğŸ˜Ÿ	True
bubble	ğŸ›€	True
regional indicator symbol letters kn	ğŸ‡°ğŸ‡³	True
answer	ğŸ’	True
japanese	ğŸ‘¹	True
vine	ğŸ‡	True
umbrella	â˜‚	True
ear of rice	ğŸŒ¾	True
pushpin	ğŸ“Œ	True
mic	ğŸ¤	True
golf	â›³	True
racing	ğŸ‡	True
dvd	ğŸ“€	True
cleavage	ğŸ‘š	True
creme caramel	ğŸ®	True
chadian flag	ğŸ‡¹ğŸ‡©	True
confetti	ğŸŠ	True
splayed hand	ğŸ–	True
climax	ğŸ‰	True
smirking	ğŸ˜¼	True
white	ğŸ‘°	True
heavy large circle	â­•	True
smiling cat	ğŸ˜º	True
school	ğŸ’®	True
bunny	ğŸ‡	True
toilet wc	ğŸš¾	True
olive toned person frowning	ğŸ™ğŸ½	True
long nose face	ğŸ‘º	True
hot chocolate	â˜•	True
clothes	ğŸ‘š	True
reborn	ğŸ’š	True
value	ğŸ’²	True
candy	ğŸ«	True
castle	ğŸ°	True
speech bubble	ğŸ’¬	True
anger	ğŸ‘º	True
black baby angel	ğŸ‘¼ğŸ¿	True
regional indicator symbol letters bh	ğŸ‡§ğŸ‡­	True
potato	ğŸŸ	True
disappointed	ğŸ˜	True
hands	ğŸ‘¬	True
nautilus	ğŸš	True
kissing face with smiling eyes	ğŸ˜™	True
christian cross	âœ	True
envious	ğŸ’š	True
alembic	âš—	True
thunderbolt	âš¡	True
notifications enabled	ğŸ””	True
car	ğŸš˜	True
monsters	ğŸŒ	True
boot	ğŸº	True
rat	ğŸ€	True
ram	â™ˆ	True
dragon	ğŸ‰	True
devil fingers	ğŸ¤˜	True
hand	ğŸ™‹	True
pout	ğŸ™	True
couple with heart with two men	ğŸ‘¨â€â¤ï¸â€ğŸ‘¨	True
flag for equatorial guinea	ğŸ‡¬ğŸ‡¶	True
lemon	ğŸ‹	True
person bowing deeply	ğŸ™‡	True
light brown waving hand sign	ğŸ‘‹ğŸ¼	True
dollar	ğŸ’²	True
sars	ğŸ˜·	True
decoration	ğŸ	True
walk	ğŸš¶	True
olive toned bath	ğŸ›€ğŸ½	True
flipped	ğŸ™ƒ	True
savory	ğŸ˜‹	True
cop car	ğŸš“	True
innocent	ğŸ˜‡	True
face with medical mask	ğŸ˜·	True
constellation	â™ˆ	True
desktop computer	ğŸ–¥	True
heavy metal	ğŸ¤˜	True
crab	ğŸš	True
seafood	ğŸ£	True
white left pointing backhand index	ğŸ‘ˆ	True
medium black circle	âš«	True
baby change station	ğŸš¼	True
black and white book	ğŸ““	True
citation	ğŸš“	True
fork and knife with plate	ğŸ½	True
flag for dominica	ğŸ‡©ğŸ‡²	True
open mailbox with raised flag	ğŸ“¬	True
otsukimi	ğŸ‘	True
wc	ğŸš¾	True
newborn	ğŸš¼	True
bandaged head	ğŸ¤•	True
kissing	ğŸ˜—	True
uppercase	ğŸ” 	True
sweet potato	ğŸ 	True
beeper	ğŸ“Ÿ	True
kids crossing	ğŸš¸	True
woman	ğŸ¤	True
wish tree	ğŸ‹	True
detective	ğŸ”	True
surfing	ğŸ„	True
gallop	ğŸ	True
mans shoe	ğŸ‘	True
sky	ğŸŒ…	True
pedestrian	ğŸš·	True
bee	ğŸ	True
grow	ğŸŒ±	True
green	ğŸ	True
apple	ğŸ	True
regional indicator symbol letter i	ğŸ‡®	True
station	ğŸš‰	True
residence	ğŸ 	True
squared katakana sa	ğŸˆ‚ï¸	True
yellow dog	ğŸº	True
yearling	ğŸ	True
pants	ğŸ‘–	True
bottle	ğŸ·	True
french	ğŸŸ	True
greek	â™Šï¸	True
warm	ğŸŒº	True
bajan flag	ğŸ‡§ğŸ‡§	True
grinning	ğŸ˜¸	True
mobile phone off	ğŸ“´	True
foggy	ğŸŒ	True
ho ho ho	ğŸ…	True
chains	â›“	True
circle and star	ğŸ’«	True
grinning	ğŸ˜	True
strawberries	ğŸ“	True
tv	ğŸ“º	True
film camera	ğŸ¥	True
regional indicator symbol letters mn	ğŸ‡²ğŸ‡³	True
bunny rabbit	ğŸ‡	True
classic	ğŸŒŸ	True
horse racing	ğŸ	True
cheese	ğŸŒ›	True
public address loudspeaker	ğŸ“¢	True
flag for bahrain	ğŸ‡§ğŸ‡­	True
tattoo	âš“ï¸	True
circle	ğŸ˜‡	True
admission tickets	ğŸŸ	True
clock face four oclock	ğŸ•“	True
mortarboard	ğŸ“	True
china	ğŸ¼	True
black scissors	âœ‚ï¸	True
fart	ğŸ’¨	True
crazy	ğŸ˜œ	True
top	ğŸ”	True
bag	ğŸ’	True
boring	ğŸ’¤	True
flag for macedonia	ğŸ‡²ğŸ‡°	True
bargain sale	ğŸˆ¹	True
cherub	ğŸ‘¼	True
clockwise rightwards and leftwards open circle arrows	ğŸ”	True
tablet	ğŸ’Š	True
passport	ğŸ›‚	True
moustache man	ğŸ‘¨	True
direct hit	ğŸ¯	True
angel	ğŸ‘¼	True
kawaii	ğŸ’ 	True
regional indicator symbol letters at	ğŸ‡¦ğŸ‡¹	True
steaming	ğŸœ	True
painting	ğŸ˜±	True
livestock	ğŸ”	True
high voltage sign	âš¡ï¸	True
light brown thumbs up sign	ğŸ‘ğŸ¼	True
union jack	ğŸ‡¬ğŸ‡§	True
no smoking symbol	ğŸš­	True
yes	ğŸ™†	True
billy goat	ğŸ	True
baby	ğŸ¼	True
briefcase	ğŸ’¼	True
couple with heart	ğŸ’‘	True
prayer beads	ğŸ“¿	True
striped	ğŸ…	True
astrology	â™	True
handshake	ğŸ¤	True
automobile	ğŸš™	True
beer stein	ğŸº	True
olive toned person with pouting face	ğŸ™ğŸ½	True
sun with face	ğŸŒ	True
fried	ğŸ¤	True
buds	ğŸ§	True
holiday	ğŸƒ	True
cat	ğŸ†	True
people	ğŸ‘¥	True
rugby	ğŸ‰	True
refresh icon	ğŸ”„	True
water buffalo	ğŸƒ	True
snowboarder	ğŸ‚	True
public	ğŸšŒ	True
lungs	ğŸš¬	True
banana	ğŸŒ	True
joy	ğŸ˜¹	True
flag for benin	ğŸ‡§ğŸ‡¯	True
aqua	ğŸ’§	True
fruit	ğŸ‘	True
planets	ğŸŒŒ	True
queen	ğŸœ	True
cash	ğŸ’´	True
fire	ğŸ²	True
stiletto	ğŸ‘ 	True
flag for mozambique	ğŸ‡²ğŸ‡¿	True
hitch hike	ğŸ‘	True
moneybags	ğŸ’°	True
cash	ğŸ§	True
eyeballs	ğŸ‘€	True
alien monster	ğŸ‘¾	True
nipple	ğŸ¼	True
rice	ğŸ±	True
cityscape at dusk	ğŸŒ†	True
enthusiasm	ğŸ‘	True
arab	ğŸ‘³	True
livestock	ğŸ–	True
chain	ğŸ”—	True
flight	âœˆï¸	True
falklander flag	ğŸ‡«ğŸ‡°	True
aumkara	ğŸ•‰	True
olive toned construction worker	ğŸ‘·ğŸ½	True
school	ğŸ˜©	True
fork and knife	ğŸ´	True
pins	ğŸ³	True
tattoo	âš“	True
eyebrow sweat	ğŸ˜¥	True
smiling	ğŸ˜	True
bloated	ğŸ‹	True
flag for switzerland	ğŸ‡¨ğŸ‡­	True
passion	ğŸ˜š	True
constellation	â™“ï¸	True
steam	ğŸš‚	True
city at night	ğŸŒƒ	True
signal strength	ğŸ“¶	True
light	ğŸŒ‡	True
gem	ğŸ’	True
honey pot	ğŸ¯	True
bathing	ğŸ›€	True
sweet	ğŸª	True
bell with cancellation stroke	ğŸ”•	True
goodbye	ğŸ‘‹	True
snitch	ğŸ€	True
new year decoration	ğŸ	True
silly	ğŸ‘…	True
clipboard	ğŸ“‹	True
stars	âœ¨	True
flag for austria	ğŸ‡¦ğŸ‡¹	True
juggling	ğŸ¤¹	True
link symbol	ğŸ”—	True
cooked rice	ğŸš	True
hand up	ğŸ™‹	True
tram	ğŸšŠ	True
light brown bicyclist	ğŸš´ğŸ¼	True
corn on the cob	ğŸŒ½	True
jealous	ğŸ’š	True
clock face eight oclock	ğŸ•—	True
yeast	ğŸ	True
night	ğŸŒš	True
dvd video	ğŸ“€	True
cucumber	ğŸ¥’	True
black swimmer	ğŸŠğŸ¿	True
end	ğŸ”š	True
flag for vietnam	ğŸ‡»ğŸ‡³	True
six pointed star with middle dot	ğŸ”¯	True
flag for kyrgyzstan	ğŸ‡°ğŸ‡¬	True
european castle	ğŸ°	True
warm	ğŸŒ´	True
stop	âœ‹	True
smiley face	ğŸ˜ƒ	True
shocked face	ğŸ˜²	True
left luggage	ğŸ›…	True
red face	ğŸ˜¡	True
school satchel	ğŸ’	True
yellow	ğŸ‹	True
jaws	ğŸ¦ˆ	True
blond man	ğŸ‘±	True
double exclamation mark	â€¼ï¸	True
black diamond suit	â™¦ï¸	True
large blue diamond	ğŸ”·	True
clock face two oclock	ğŸ•‘	True
jam	ğŸ¸	True
deeper brown person frowning	ğŸ™ğŸ¾	True
feats of strength	ğŸ’ª	True
bust in silhouette	ğŸ‘¤	True
camel	ğŸª	True
bear	ğŸ¾	True
bend	ğŸ™‡	True
wave	ğŸŒŠ	True
bahrainian flag	ğŸ‡§ğŸ‡­	True
lucky	ğŸ€	True
dollar bill	ğŸ’µ	True
formula one	ğŸ	True
miniature poodle	ğŸ©	True
hugging	ğŸ¤—	True
travel	ğŸ›‚	True
victory hand	âœŒï¸	True
envelope with downwards arrow above	ğŸ“©	True
black father christmas	ğŸ…ğŸ¿	True
queen	ğŸ°	True
chicken	ğŸ£	True
flag for romania	ğŸ‡·ğŸ‡´	True
agreement	ğŸˆ´	True
party	ğŸˆ	True
tropical fish	ğŸ 	True
electric torch	ğŸ”¦	True
shoshinsha mark	ğŸ”°	True
stay	ğŸ®	True
weary	ğŸ˜©	True
stew	ğŸ²	True
evening	ğŸŒƒ	True
square	ğŸ†—	True
slot machine	ğŸ°	True
confetti ball	ğŸŠ	True
speaker with cancellation stroke	ğŸ”‡	True
family of two men with one boy	ğŸ‘¨â€ğŸ‘¨â€ğŸ‘¦	True
america	ğŸˆ	True
transport	ğŸš	True
night	ğŸŒ’	True
flag for malawi	ğŸ‡²ğŸ‡¼	True
own	ğŸˆ¶	True
snapchat mutual best friends	ğŸ˜	True
jewish	ğŸ•	True
sick	ğŸ’«	True
home	ğŸŒ	True
fall	ğŸ‚	True
deeper brown raised hand	âœ‹ğŸ¾	True
wedding	ğŸŠ	True
left triangle	â—€ï¸	True
tree	ğŸŒ°	True
white girl	ğŸ‘§ğŸ»	True
deeper brown runner	ğŸƒğŸ¾	True
devil	ğŸ‘¹	True
work	ğŸˆº	True
tennis ball	ğŸ¾	True
regional indicator symbol letters as	ğŸ‡¦ğŸ‡¸	True
backhand	ğŸ¤š	True
flag for south sudan	ğŸ‡¸ğŸ‡¸	True
crescent moon	ğŸŒ™	True
city	ğŸš–	True
ropeway	ğŸš¡	True
water	ğŸ›€	True
flag for south korea	ğŸ‡°ğŸ‡·	True
tent	ğŸª	True
kamboko	ğŸ¥	True
destination	ğŸˆ	True
nintendo	ğŸ®	True
flame	ğŸ”¥	True
flush	ğŸ˜³	True
basin	ğŸ›	True
flower	ğŸŒ»	True
white medium small square	â—½ï¸	True
regional indicator symbol letters gd	ğŸ‡¬ğŸ‡©	True
flashing light	ğŸš¨	True
white bride with veil	ğŸ‘°ğŸ»	True
thumb	ğŸ‘	True
grin	ğŸ˜	True
formula	ğŸ¼	True
regional indicator symbol letters re	ğŸ‡·ğŸ‡ª	True
bar	ğŸ®	True
light brown runner	ğŸƒğŸ¼	True
morning	ğŸŒ„	True
glowing	ğŸŒŸ	True
sound	ğŸ§	True
king	ğŸ°	True
police	ğŸ‘®	True
monkey	ğŸ™Š	True
slightly sad	ğŸ™	True
flag for mauritania	ğŸ‡²ğŸ‡·	True
dejected	ğŸ™	True
regional indicator symbol letters qa	ğŸ‡¶ğŸ‡¦	True
soap	ğŸ›	True
oni	ğŸ‘¹	True
water	ğŸ’§	True
blossom	ğŸŒ¸	True
maize	ğŸŒ½	True
dutch flag	ğŸ‡³ğŸ‡±	True
core	ğŸ	True
weary cat face	ğŸ™€	True
elderly man	ğŸ‘´	True
racing flag	ğŸ	True
white older man	ğŸ‘´ğŸ»	True
north	ğŸŒ	True
flag for gambia	ğŸ‡¬ğŸ‡²	True
ride	ğŸ 	True
aerial tramway	ğŸš¡	True
japanese	ğŸ¯	True
pet	ğŸ•	True
frustrated	ğŸ˜¤	True
flag for canada	ğŸ‡¨ğŸ‡¦	True
soft ice cream	ğŸ¦	True
britain	ğŸ’·	True
rainy	â˜”	True
astrology	â™Œ	True
magician	ğŸ©	True
sign	â™’	True
sophisticated	ğŸ©	True
sound	ğŸ‘	True
flock	ğŸ‘	True
sun	ğŸŒ‡	True
white raised hand with part between middle and ring fingers	ğŸ––ğŸ»	True
hat	ğŸ‘’	True
superbowl	ğŸˆ	True
cute	ğŸ’ 	True
noodles with chopsticks	ğŸœ	True
cash	ğŸ’·	True
trot	ğŸ	True
wash	ğŸ›€	True
flag for american samoa	ğŸ‡¦ğŸ‡¸	True
letter	ğŸ’Œ	True
æº€	ğŸˆµ	True
long nose	ğŸ¤¥	True
pan	ğŸ³	True
grinning face	â˜ºï¸	True
small bag	ğŸ‘	True
unamused	ğŸ˜’	True
sunset	ğŸŒ…	True
petals	ğŸŒ¹	True
deeper brown father christmas	ğŸ…ğŸ¾	True
face screaming in fear	ğŸ˜±	True
rail	ğŸšˆ	True
evergreen	ğŸ„	True
hot	ğŸŒ‹	True
users	ğŸ‘¥	True
smoke	ğŸš¬	True
phone battery	ğŸ”‹	True
regional indicator symbol letters il	ğŸ‡®ğŸ‡±	True
flag for sri lanka	ğŸ‡±ğŸ‡°	True
sleep face	ğŸ˜´	True
flag for china	ğŸ‡¨ğŸ‡³	True
regional indicator symbol letters fr	ğŸ‡«ğŸ‡·	True
bus	ğŸš	True
family of two women with one boy	ğŸ‘©â€ğŸ‘©â€ğŸ‘¦	True
bicycle	ğŸš´	True
black white down pointing backhand index	ğŸ‘‡ğŸ¿	True
smooch	ğŸ˜š	True
powerboat	ğŸš¤	True
lipstick	ğŸ’„	True
regional indicator symbol letters ae	ğŸ‡¦ğŸ‡ª	True
protection	ğŸŒ‚	True
roller	ğŸ¢	True
cool square	ğŸ†’	True
siren	ğŸš¨	True
pint	ğŸº	True
video	ğŸ®	True
flag for turkey	ğŸ‡¹ğŸ‡·	True
love	ğŸŒ¹	True
red dress woman	ğŸ’ƒ	True
automobile	ğŸš•	True
star	â­	True
carousel horse	ğŸ 	True
hinamatsuri	ğŸ	True
cocktail	ğŸ¸	True
kissing	ğŸ˜˜	True
amusement	ğŸ 	True
ceremonial	ğŸ’‚	True
zodiac	â™	True
heart	ğŸ˜˜	True
no entry	â›”ï¸	True
regional indicator symbol letters dj	ğŸ‡©ğŸ‡¯	True
craps	ğŸ²	True
freestyle	ğŸ¿	True
sky	ğŸŒ”	True
snowboarding	ğŸ‚	True
sad cat	ğŸ˜¿	True
smiley moon	ğŸŒ	True
billiards	ğŸ±	True
deeper brown horse racing	ğŸ‡ğŸ¾	True
sad	ğŸ˜”	True
shawarma	ğŸ¥™	True
scales of justice	âš–	True
heart alarm	ğŸ’“	True
person frowning	ğŸ™	True
memorandum	ğŸ“	True
cable car	ğŸš¡	True
pig nose	ğŸ½	True
hyperopia	ğŸ‘“	True
sparkle	âœ¨	True
stalk	ğŸŒ½	True
woman	ğŸš»	True
ufo	ğŸ‘½	True
showgirls	ğŸ‘¯	True
splashing water	ğŸ’¦	True
snowflake	â„ï¸	True
flag for eritrea	ğŸ‡ªğŸ‡·	True
music notes	ğŸ¶	True
umbrella with rain drops	â˜”ï¸	True
lady	ğŸ‘©	True
blossom	ğŸŒ¼	True
fortune teller	ğŸ”®	True
soon with rightwards arrow above	ğŸ”œ	True
bowl of ice cream	ğŸ¨	True
drooling face	ğŸ¤¤	True
bank	ğŸ§	True
roasted	ğŸ 	True
cat paw prints	ğŸ¾	True
regional indicator symbol letters mv	ğŸ‡²ğŸ‡»	True
pot of food	ğŸ²	True
british	ğŸ’‚	True
regional indicator symbol letters us	ğŸ‡ºğŸ‡¸	True
locomotive	ğŸš‚	True
music	ğŸº	True
clapper	ğŸ¬	True
snap	ğŸ¢	True
delicious	ğŸ˜‹	True
boiled rice	ğŸš	True
tiger face	ğŸ¯	True
peace sign	â˜®	True
exhausted	ğŸ˜«	True
phone with arrow	ğŸ“²	True
narutomaki	ğŸ¥	True
sweet	ğŸ¬	True
gown	ğŸ‘—	True
skinny	ğŸ‘–	True
eyes	ğŸ‘€	True
luggage	ğŸ›…	True
dragon head	ğŸ²	True
night	ğŸŒ“	True
blooper	ğŸ†–	True
space	ğŸŒ	True
sleepy	ğŸ˜©	True
womans sandal	ğŸ‘¡	True
crosswalk	ğŸš¸	True
white princess	ğŸ‘¸ğŸ»	True
medical	ğŸ˜·	True
little penguin	ğŸ§	True
good luck	ğŸ¤	True
white mountain bicyclist	ğŸšµğŸ»	True
one hundred	ğŸ’¯	True
russet	ğŸŸ	True
mad face	ğŸ˜¤	True
fountain	â›²ï¸	True
flag for netherlands	ğŸ‡³ğŸ‡±	True
vertical	ğŸš¦	True
two hearts	ğŸ’•	True
olive toned pedestrian	ğŸš¶ğŸ½	True
sign	â™ˆï¸	True
night	ğŸŒ—	True
sakura	ğŸŒ¸	True
fed up	ğŸ˜«	True
tears	ğŸ˜¹	True
yellow bird	ğŸ¤	True
bird	ğŸ¥	True
lorry	ğŸš›	True
cocktail glass	ğŸ¸	True
numbers	ğŸ”¢	True
dromedary camel	ğŸª	True
night	ğŸŒ˜	True
water	ğŸš¿	True
mens symbol	ğŸš¹	True
raised fist	âœŠ	True
greek	â™	True
livestock	ğŸ	True
winking	ğŸ˜œ	True
drop bear	ğŸ¨	True
cute	ğŸ¤	True
disney	ğŸ‘¸	True
flag for australia	ğŸ‡¦ğŸ‡º	True
multiple heart	ğŸ’—	True
transport	ğŸš¡	True
moyai	ğŸ—¿	True
princess	ğŸ‘¸	True
saints	ğŸƒ	True
string quartet	ğŸ»	True
maple	ğŸ	True
regional indicator symbol letters pk	ğŸ‡µğŸ‡°	True
when you wish upon a star	ğŸŒ 	True
red cross	ğŸ‡¨ğŸ‡­	True
noodles	ğŸœ	True
smooch	ğŸ˜™	True
astrology	â™	True
syrup	ğŸ	True
jet	âœˆï¸	True
error	ğŸ›	True
user	ğŸ‘¤	True
tree	ğŸŒ³	True
border control	ğŸ›‚	True
music	ğŸ¶	True
olive toned thumbs down sign	ğŸ‘ğŸ½	True
bookmark tabs	ğŸ“‘	True
adultery	ğŸ©	True
bathroom	ğŸš¾	True
wedding	ğŸ	True
train	ğŸš	True
jumbo	âœˆï¸	True
regional indicator symbol letters lr	ğŸ‡±ğŸ‡·	True
happy face	ğŸ˜€	True
closed lock with key	ğŸ”	True
spaghetti bolognese	ğŸ	True
sunface	ğŸŒ	True
fuel pump	â›½ï¸	True
ride	ğŸ¢	True
irritated	ğŸ˜ 	True
olive toned thumbs up sign	ğŸ‘ğŸ½	True
ten pin bowling	ğŸ³	True
anthropomorphic	ğŸŒ	True
åˆ	ğŸˆ´	True
light brown swimmer	ğŸŠğŸ¼	True
accessory	ğŸ‘›	True
stars	â™Œ	True
yellow woman	ğŸ‘©	True
poop	ğŸ’©	True
rich	ğŸ’°	True
flag in hole	â›³ï¸	True
hamster	ğŸ¹	True
handyman	ğŸ”¨	True
constellation	â™ï¸	True
bicyclist	ğŸš´	True
fax	ğŸ“ 	True
sorry	ğŸ™	True
stars	â™	True
clockwise rightwards and leftwards open circle arrows with circled one overlay	ğŸ”‚	True
vespa	ğŸ›µ	True
minivan	ğŸš	True
black universal recycling symbol	â™»ï¸	True
andorran flag	ğŸ‡¦ğŸ‡©	True
sealed lips	ğŸ¤	True
happy face	â˜ºï¸	True
brilliance	ğŸ’®	True
brown leaves	ğŸ‚	True
black bath	ğŸ›€ğŸ¿	True
knife	ğŸ”ª	True
microscope	ğŸ”¬	True
middle finger	ğŸ‘†	True
sashimi	ğŸ£	True
escargot	ğŸŒ	True
cheese wedge	ğŸ§€	True
flag for serbia	ğŸ‡·ğŸ‡¸	True
meow	ğŸˆ	True
loop symbol	ğŸ”	True
right anger bubble	ğŸ—¯	True
black bicyclist	ğŸš´ğŸ¿	True
bumble bee	ğŸ	True
love note	ğŸ’Œ	True
greek	â™’ï¸	True
jaguar	ğŸ†	True
melon	ğŸˆ	True
fire	ğŸ”¥	True
dog	ğŸ¶	True
arrow pointing rightwards then curving upwards	â¤´ï¸	True
bicyclist	ğŸšµ	True
ram	ğŸ	True
cute lion	ğŸ¦	True
snail	ğŸŒ	True
clapping	ğŸ‘	True
weight lifter	ğŸ‹	True
kissy	ğŸ˜™	True
father	ğŸ…	True
wild west	ğŸŒµ	True
spare	ğŸ³	True
keycap digit one	1ï¸âƒ£	True
indian	ğŸ‘³	True
magic 8 ball	ğŸ±	True
laugh	ğŸ˜†	True
distress signal	ğŸ†˜	True
popcorn	ğŸ¿	True
flag for sweden	ğŸ‡¸ğŸ‡ª	True
smiley	ğŸ˜Š	True
seat	ğŸ’º	True
british virgin islander flag	ğŸ‡»ğŸ‡¬	True
home alone	ğŸ˜±	True
world emoji day	ğŸ“…	True
baby chicken	ğŸ£	True
blond	ğŸ‘±	True
gamble	ğŸ°	True
glass	ğŸ¸	True
flag for micronesia	ğŸ‡«ğŸ‡²	True
evening	ğŸŒ†	True
poodle	ğŸ©	True
blonde	ğŸ‘±	True
moon	ğŸ‘	True
regional indicator symbol letters nz	ğŸ‡³ğŸ‡¿	True
first	ğŸŒ“	True
white frowning face	â˜¹	True
zodiac	â™Œ	True
girl	ğŸ‘ª	True
white flexed biceps	ğŸ’ªğŸ»	True
kiss face	ğŸ˜™	True
explode	ğŸŒ‹	True
deeper brown older man	ğŸ‘´ğŸ¾	True
comet	â˜„	True
losing money	ğŸ’¸	True
joke	ğŸ˜‰	True
white white down pointing backhand index	ğŸ‘‡ğŸ»	True
astonished face	ğŸ˜²	True
black dancer	ğŸ’ƒğŸ¿	True
bawling	ğŸ˜­	True
universe	ğŸŒŒ	True
cone	ğŸ¦	True
bathers	ğŸ‘™	True
page facing up	ğŸ“„	True
locomotive	ğŸš†	True
cry	ğŸ˜­	True
cell phone	ğŸ“±	True
japanese dress	ğŸ‘˜	True
child	ğŸ‘¶	True
regional indicator symbol letters uz	ğŸ‡ºğŸ‡¿	True
currency	ğŸ’·	True
mother	ğŸ‘ª	True
easter	ğŸ‡	True
flag for cayman islands	ğŸ‡°ğŸ‡¾	True
turkish flag	ğŸ‡¹ğŸ‡·	True
deeper brown nail polish	ğŸ’…ğŸ¾	True
food	ğŸš	True
entry	ğŸš«	True
standard poodle	ğŸ©	True
white large square	â¬œï¸	True
sparkling wine	ğŸ¾	True
umbrella	ğŸŒ‚	True
palette	ğŸ¨	True
gift heart	ğŸ’	True
greek	â™“	True
dragon	ğŸ²	True
bookmark	ğŸ”–	True
zodiac	â›	True
articulated	ğŸš›	True
shadow moon	ğŸŒ‘	True
moon	ğŸŒ’	True
devil horns	ğŸ‘¿	True
flag for czech republic	ğŸ‡¨ğŸ‡¿	True
pin	ğŸ³	True
waffle	ğŸ¨	True
study	ğŸ˜©	True
fall	ğŸŒ³	True
flag for norfolk island	ğŸ‡³ğŸ‡«	True
elementary school	ğŸ«	True
video tape	ğŸ“¼	True
desert	ğŸª	True
hot	ğŸ”¥	True
italian	ğŸ	True
tears	ğŸ˜‚	True
paw	ğŸ¾	True
womans boots	ğŸ‘¢	True
chequered flag	ğŸ	True
strawberry	ğŸ“	True
fungus	ğŸ„	True
flag for ecuador	ğŸ‡ªğŸ‡¨	True
trident emblem	ğŸ”±	True
kissing	ğŸ˜š	True
sunnies	ğŸ˜	True
sign	ğŸ‘	True
regional indicator symbol letters gt	ğŸ‡¬ğŸ‡¹	True
flag for Ã¥land islands	ğŸ‡¦ğŸ‡½	True
top	ğŸª	True
announcement	ğŸ‰	True
digital camera	ğŸ“·	True
supernatural	ğŸ‘º	True
regional indicator symbol letters th	ğŸ‡¹ğŸ‡­	True
haircut	ğŸ’‡	True
clean	ğŸ›	True
arabian camel	ğŸª	True
dusk city	ğŸŒ†	True
ride	ğŸ„	True
frown	ğŸ˜¾	True
heart above dot	â£	True
regional indicator symbol letters bt	ğŸ‡§ğŸ‡¹	True
circled latin capital letter m	â“‚ï¸	True
loving cat	ğŸ˜»	True
spock	ğŸ––	True
kiss mark	ğŸ’‹	True
smiling sun	ğŸŒ	True
pufferfish	ğŸ¡	True
flag for nauru	ğŸ‡³ğŸ‡·	True
raise	ğŸ™‹	True
bag	ğŸ›„	True
search icon	ğŸ”	True
boarding	ğŸ‚	True
suspension	ğŸŒ‰	True
flag for mauritius	ğŸ‡²ğŸ‡º	True
pie	ğŸ•	True
gondola	ğŸš¡	True
grandma	ğŸ‘µ	True
nursery	ğŸš¼	True
flag for greece	ğŸ‡¬ğŸ‡·	True
red apple	ğŸ	True
grey rat	ğŸ€	True
church building	â›ª	True
birthday	ğŸ	True
chicken drumstick	ğŸ—	True
pot	ğŸ¯	True
chicken	ğŸ¥	True
zzz face	ğŸ˜´	True
yellow star	â­	True
chestnut	ğŸŒ°	True
french southern lands flag	ğŸ‡¹ğŸ‡«	True
regional indicator symbol letters gp	ğŸ‡¬ğŸ‡µ	True
regional indicator symbol letters vg	ğŸ‡»ğŸ‡¬	True
closet	ğŸš¾	True
black	â¤ï¸	True
canada	ğŸ’µ	True
white exclamation mark ornament	â•	True
rice	ğŸŒ¾	True
fox face	ğŸ¦Š	True
japanese	ã€½ï¸	True
flexing arm muscles	ğŸ’ª	True
smiling face with open mouth and smiling eyes	ğŸ˜„	True
sad devil	ğŸ‘¿	True
phase	ğŸŒ“	True
tropical	ğŸ¹	True
drool	ğŸ¤¤	True
frustrated	ğŸ˜	True
elementary	ğŸ«	True
kiwi flag	ğŸ‡³ğŸ‡¿	True
cigarette	ğŸš­	True
lady beetle	ğŸ	True
bullseye	ğŸ¯	True
pot	ğŸ‘Œ	True
thumbs up sign	ğŸ‘	True
violin	ğŸ»	True
full moon with face	ğŸŒ	True
hot	ğŸ²	True
white small square	â–«ï¸	True
dark sunglasses	ğŸ•¶	True
regional indicator symbol letters br	ğŸ‡§ğŸ‡·	True
bathroom	ğŸ›€	True
acoustic guitar	ğŸ¸	True
big grin	ğŸ˜†	True
dvd rom	ğŸ“€	True
regional indicator symbol letters pt	ğŸ‡µğŸ‡¹	True
tag	ğŸ”–	True
blank	ğŸ˜‘	True
black heart suit	â™¥ï¸	True
school	ğŸ«	True
horse	ğŸ 	True
ornaments	ğŸ„	True
ping pong	ğŸ“	True
performing arts	ğŸ­	True
regional indicator symbol letters ml	ğŸ‡²ğŸ‡±	True
mecca	ğŸ•‹	True
light brown clapping hands sign	ğŸ‘ğŸ¼	True
kiss	ğŸ˜˜	True
rotary phone	â˜ï¸	True
sheet music	ğŸ¼	True
japanese	ğŸ¶	True
pain	ğŸ˜¬	True
crocodile	ğŸŠ	True
airplane arriving	ğŸ›¬	True
cherry blossom	ğŸŒ¸	True
flag for suriname	ğŸ‡¸ğŸ‡·	True
castle	ğŸ¯	True
sagittarius	â™ï¸	True
desire	â¤ï¸	True
christmas	ğŸŒ²	True
letters	ğŸ”¤	True
disapprove	ğŸ˜’	True
baby change symbol	ğŸš¼	True
mahjong	ğŸ€„	True
archery	ğŸ¹	True
flag for israel	ğŸ‡®ğŸ‡±	True
rabbit face	ğŸ°	True
taco	ğŸŒ®	True
hump	ğŸª	True
bow	ğŸ™‡	True
slop	ğŸ–	True
young	ğŸ‘±	True
cub	ğŸ¼	True
down triangle	ğŸ”½	True
sun	ğŸ˜	True
card with heart	â™¥ï¸	True
cone	ğŸ¨	True
truck	ğŸš›	True
voicemail	â¿	True
beninese flag	ğŸ‡§ğŸ‡¯	True
female	ğŸšº	True
winter	ğŸ„	True
smirk	ğŸ˜¼	True
love	ğŸ˜½	True
water wave	ğŸŒŠ	True
wheel	ğŸ¡	True
sunset	ğŸŒ†	True
hot	ğŸª	True
jockey	ğŸ‡	True
busts in silhouette	ğŸ‘¥	True
rebirth	ğŸ’š	True
circled ideograph congratulation	ãŠ—ï¸	True
fruit	ğŸ	True
cheeky	ğŸ˜›	True
wallet	ğŸ‘›	True
ballot box with ballot	ğŸ—³	True
rich	ğŸ®	True
white horse racing	ğŸ‡ğŸ»	True
olaf	â›„	True
french fries	ğŸŸ	True
flag for cape verde	ğŸ‡¨ğŸ‡»	True
horse	ğŸ	True
school crossing	ğŸš¸	True
smirk	ğŸ˜	True
color	ğŸŒ„	True
stop	ğŸš¦	True
black bat	ğŸ¦‡	True
flag for swaziland	ğŸ‡¸ğŸ‡¿	True
flag for senegal	ğŸ‡¸ğŸ‡³	True
gift	ğŸ	True
nice	ğŸ…	True
light brown woman	ğŸ‘©ğŸ¼	True
toy poodle	ğŸ©	True
prolific	ğŸ‡	True
thinker	ğŸ¤”	True
dizzy symbol	ğŸ’«	True
scorpius	â™ï¸	True
white dancer	ğŸ’ƒğŸ»	True
orange	ğŸŠ	True
satellite	ğŸ›°	True
smile	ğŸ˜Š	True
yellow fruit	ğŸ‹	True
deeper brown ear	ğŸ‘‚ğŸ¾	True
tennis racket	ğŸ¾	True
flag for panama	ğŸ‡µğŸ‡¦	True
gift box	ğŸ	True
pastry	ğŸ©	True
light brown construction worker	ğŸ‘·ğŸ¼	True
transportation	ğŸš	True
cosmetic	ğŸ‘	True
scorpius	â™	True
furin	ğŸ	True
cantaloupe emoiji	ğŸˆ	True
account	ğŸ‘¤	True
cold	â¤ï¸	True
love	â¤ï¸	True
jazz	ğŸ·	True
green snake	ğŸ	True
sassy girl	ğŸ’	True
reflective	ğŸ˜”	True
mountain bicyclist	ğŸšµ	True
deeper brown bath	ğŸ›€ğŸ¾	True
love	ğŸ’š	True
sedan	ğŸš—	True
regional indicator symbol letters ao	ğŸ‡¦ğŸ‡´	True
diversity	ğŸŒˆ	True
love heart	â¤ï¸	True
beer	ğŸ»	True
shifty eyes	ğŸ‘€	True
baseball	âš¾	True
regional indicator symbol letter o	ğŸ‡´	True
garbage	ğŸš¯	True
love hotel	ğŸ©	True
hearty	ğŸ²	True
perplex	ğŸ˜–	True
sunrise	ğŸŒ…	True
astrology	â™Šï¸	True
closed umbrella	ğŸŒ‚	True
pipe	ğŸ©	True
emergency	ğŸš‘	True
fÅ«rin	ğŸ	True
meat	ğŸ–	True
green salad	ğŸ¥—	True
gesture	ğŸ‘	True
couple in love	ğŸ’‘	True
prints	ğŸ¾	True
flag for greenland	ğŸ‡¬ğŸ‡±	True
aussie flag	ğŸ‡¦ğŸ‡º	True
chicken	ğŸ¤	True
note	ğŸµ	True
imperial dolls	ğŸ	True
ring	ğŸ˜‡	True
smiling	ğŸ˜†	True
young	ğŸ£	True
clock face three oclock	ğŸ•’	True
mountain	ğŸ¿	True
zodiac	â™ï¸	True
mug	ğŸ»	True
liar	ğŸ¤¥	True
olive toned bicyclist	ğŸš´ğŸ½	True
bridge	ğŸŒ	True
hammer and wrench	ğŸ› 	True
tap dance	ğŸ‘¯	True
chamorro flag	ğŸ‡¬ğŸ‡º	True
walk	ğŸš·	True
toadstool	ğŸ„	True
smile	ğŸ˜º	True
ocean	ğŸŒ€	True
pucker	ğŸ˜™	True
bill	ğŸ’´	True
road	ğŸŒ‰	True
car	ğŸšƒ	True
horn	ğŸº	True
steaming bowl	ğŸœ	True
stop	ğŸ™…	True
globe with meridians	ğŸŒ	True
smile	ğŸ˜	True
think	ğŸ’­	True
ok	ğŸ‘Œ	True
tree	ğŸ’	True
olive toned ok hand sign	ğŸ‘ŒğŸ½	True
chimney	ğŸ©	True
high brightness symbol	ğŸ”†	True
boy	ğŸ‘¦	True
church heart	ğŸ’’	True
hot beverage	â˜•	True
irish	ğŸ€	True
work	ğŸ’¸	True
beauty	ğŸ’…	True
sweet	ğŸ 	True
pencil and paper	ğŸ“	True
instrument	ğŸº	True
flag for grenada	ğŸ‡¬ğŸ‡©	True
bacon	ğŸ¥“	True
cow	ğŸ®	True
kissing cat	ğŸ˜½	True
wish	ğŸ‹	True
happy face	ğŸ˜Š	True
balloon	ğŸˆ	True
olive toned princess	ğŸ‘¸ğŸ½	True
flag for kosovo	ğŸ‡½ğŸ‡°	True
musical	ğŸ¶	True
flexed biceps	ğŸ’ª	True
winky face	ğŸ˜‰	True
dromedary	ğŸª	True
mochi	ğŸ¡	True
flag for sierra leone	ğŸ‡¸ğŸ‡±	True
novel	ğŸ“–	True
flipping the bird	ğŸ–•	True
koala bear	ğŸ¨	True
tar	ğŸš­	True
oncoming taxi	ğŸš–	True
restaurant	ğŸ´	True
pile of books	ğŸ“š	True
boat	âš“ï¸	True
cooked	ğŸ–	True
kiss	ğŸ‘…	True
indian food	ğŸ›	True
field hockey stick and ball	ğŸ‘	True
agriculture	ğŸ	True
cityscape	ğŸ™	True
white man with gua pi mao	ğŸ‘²ğŸ»	True
bird	ğŸ¤	True
rugby football	ğŸ‰	True
lick	ğŸ­	True
swirl	ğŸ¥	True
train	ğŸš†	True
pensive	ğŸ˜”	True
play button	â–¶ï¸	True
veteran	ğŸ’œ	True
flag for ukraine	ğŸ‡ºğŸ‡¦	True
personal computer	ğŸ’»	True
bento box	ğŸ±	True
wrap	ğŸ€	True
shopping	ğŸ‘š	True
flag for samoa	ğŸ‡¼ğŸ‡¸	True
white rowboat	ğŸš£ğŸ»	True
tsukimi	ğŸ‘	True
flag for cyprus	ğŸ‡¨ğŸ‡¾	True
ladies hat	ğŸ‘’	True
world	ğŸŒ	True
cute	ğŸ½	True
snow	ğŸ‚	True
bathroom	ğŸš¹	True
lip gloss	ğŸ’„	True
umbrella with rain drops	â˜”	True
cold	ğŸ˜	True
spanish flag	ğŸ‡ªğŸ‡¸	True
linked chain	ğŸ”—	True
onsen	â™¨ï¸	True
grinning face	ğŸ˜„	True
ambulance	ğŸš‘	True
lunchbox	ğŸ±	True
emergency	ğŸš“	True
sadface	ğŸ˜”	True
brÃ»lÃ©e	ğŸ®	True
festival	ğŸ‘	True
curling loop	â°	True
regional indicator symbol letters fi	ğŸ‡«ğŸ‡®	True
kiss	ğŸ˜—	True
white open hands sign	ğŸ‘ğŸ»	True
sparkles	âœ¨	True
flag for ethiopia	ğŸ‡ªğŸ‡¹	True
regional indicator symbol letters si	ğŸ‡¸ğŸ‡®	True
draft	ğŸ	True
white medium square	â—»ï¸	True
smiling	ğŸ˜„	True
butterflies in stomach	ğŸ’“	True
happy devil	ğŸ˜ˆ	True
clairvoyant	ğŸ”®	True
strike	ğŸ³	True
royalty	ğŸ’œ	True
birthday cake	ğŸ‚	True
bow	ğŸ€	True
constellation	â™ï¸	True
amphora	ğŸº	True
loving couple	ğŸ’‘	True
four	ğŸ€	True
fruit	ğŸ…	True
heavy black heart	â¤ï¸	True
beamed pair of eighth notes	ğŸµ	True
luck	ğŸ°	True
wardrobe	ğŸ‘š	True
regional indicator symbol letters cr	ğŸ‡¨ğŸ‡·	True
crossing	ğŸš¸	True
puzzled	ğŸ˜•	True
bow and arrow	ğŸ¹	True
fighter	ğŸš’	True
flag for egypt	ğŸ‡ªğŸ‡¬	True
perfect score	ğŸ’¯	True
holiday	ğŸ‹	True
chocolate cookie	ğŸª	True
baby	ğŸ‘¼	True
accept	ğŸ™†	True
id	ğŸ†”	True
finals	ğŸ™€	True
luggage	ğŸ›„	True
tortoise	ğŸ¢	True
scorpion	ğŸ¦‚	True
hands	ğŸ™	True
doge	ğŸ•	True
wireless	ğŸ“»	True
flag for kenya	ğŸ‡°ğŸ‡ª	True
constellation	â™	True
smoking symbol	ğŸš¬	True
custard	ğŸ®	True
mouth	ğŸ‘„	True
teddy bear	ğŸ»	True
eye roll	ğŸ™„	True
squared free	ğŸ†“	True
purchase	ğŸ«	True
constellation	â™’ï¸	True
manicure	ğŸ’…	True
planet	ğŸŒ	True
sushi	ğŸ£	True
japanese goblin	ğŸ‘º	True
slow	ğŸ¢	True
man in business suit levitating	ğŸ•´	True
keycap digit zero	0ï¸âƒ£	True
fast forward	â©	True
steaming	ğŸ˜¤	True
bees	ğŸ¯	True
daughter	ğŸ‘­	True
black white right pointing backhand index	ğŸ‘‰ğŸ¿	True
hockey	ğŸ‘	True
greek	â™ï¸	True
lower left crayon	ğŸ–	True
oar	ğŸš£	True
red balloon	ğŸˆ	True
railway car	ğŸšƒ	True
regional indicator symbol letters gr	ğŸ‡¬ğŸ‡·	True
ringer disabled	ğŸ”•	True
regional indicator symbol letters tm	ğŸ‡¹ğŸ‡²	True
jellyfish	ğŸ	True
love	ğŸ˜	True
deeper brown bride with veil	ğŸ‘°ğŸ¾	True
fire department	ğŸš’	True
doorway	ğŸšª	True
high five	ğŸ™	True
smiley face	ğŸ˜€	True
coin bag	ğŸ‘›	True
peel	ğŸŒ	True
stars heart	ğŸ’–	True
flag for guadeloupe	ğŸ‡¬ğŸ‡µ	True
ladybird	ğŸ	True
joint	ğŸ‘Œ	True
home	ğŸ 	True
sparkle heart	ğŸ’–	True
potable water symbol	ğŸš°	True
raised hand with fingers splayed	ğŸ–	True
female restroom	ğŸšº	True
negative squared latin capital letter o	ğŸ…¾ï¸	True
owl	ğŸ¦‰	True
magic	ğŸ©	True
information source	â„¹ï¸	True
anxious	ğŸ˜Ÿ	True
male	ğŸ‘¨	True
crystal	â„ï¸	True
sexual face	ğŸ˜	True
blue book	ğŸ“˜	True
happy	ğŸ˜º	True
crying face	ğŸ˜¢	True
sign	â™“	True
girls	ğŸ	True
storm	ğŸŒ€	True
ferment	ğŸ¶	True
flag for bahamas	ğŸ‡§ğŸ‡¸	True
championship trophy	ğŸ†	True
celebration	ğŸ¾	True
flag for tokelau	ğŸ‡¹ğŸ‡°	True
nobel	ğŸ°	True
flag for french guiana	ğŸ‡¬ğŸ‡«	True
xmas	ğŸ„	True
fireworks	ğŸ†	True
squared sos	ğŸ†˜	True
fried shrimp	ğŸ¤	True
roast	ğŸ 	True
sign	ğŸš¹	True
white face massage	ğŸ’†ğŸ»	True
pedal	ğŸšµ	True
shooting star	ğŸŒ 	True
misery	ğŸ˜§	True
flag	ğŸ	True
oral	ğŸ™Š	True
cheese	ğŸŒ”	True
night	ğŸŒƒ	True
railroad car	ğŸšƒ	True
chocolate	ğŸ«	True
bar chart	ğŸ“Š	True
clutch	ğŸ‘	True
tear	ğŸ’§	True
memo	ğŸ“	True
iraqi flag	ğŸ‡®ğŸ‡¶	True
south	ğŸŒ	True
love	ğŸ¾	True
monkey face	ğŸµ	True
crying	ğŸ˜­	True
tide	ğŸŒŠ	True
hearing	ğŸ‘‚	True
film	ğŸ¬	True
light brown raised hand	âœ‹ğŸ¼	True
game	ğŸ®	True
flag for belgium	ğŸ‡§ğŸ‡ª	True
board	ğŸ‚	True
soccer	âš½	True
hugging face	ğŸ¤—	True
shinto shrine	â›©	True
sky	ğŸŒ„	True
win	ğŸŠ	True
earth	ğŸŒ	True
waste	ğŸš¾	True
men	ğŸš¹	True
drinkable	ğŸš°	True
oncoming bus	ğŸš	True
regional indicator symbol letters bi	ğŸ‡§ğŸ‡®	True
magnifier	ğŸ”	True
yen note	ğŸ’´	True
policewoman	ğŸ‘®	True
doctor	ğŸ˜·	True
horse race	ğŸ‡	True
pa system	ğŸ“¢	True
filly	ğŸ	True
okay	ğŸ™†	True
space	ğŸŒ	True
love	ğŸ’›	True
h20	ğŸ’§	True
hand	ğŸ‘	True
ballet	ğŸ’ƒ	True
regional indicator symbol letters lu	ğŸ‡±ğŸ‡º	True
spy	ğŸ•µ	True
flag for faroe islands	ğŸ‡«ğŸ‡´	True
eye	ğŸ‘“	True
flag for turkmenistan	ğŸ‡¹ğŸ‡²	True
regional indicator symbol letters ee	ğŸ‡ªğŸ‡ª	True
gown	ğŸ‘°	True
motion	ğŸ¦	True
icecream	ğŸ¦	True
monster	ğŸ‘¹	True
check	âœ…	True
dissatisfied	ğŸ˜’	True
shield	ğŸ”°	True
camcorder	ğŸ¥	True
gold star	ğŸŒŸ	True
regional indicator symbol letters al	ğŸ‡¦ğŸ‡±	True
fish	â™“ï¸	True
wrist watch	âŒš	True
kidding	ğŸ˜	True
tractor	ğŸšœ	True
inhale	ğŸš­	True
no speaking	ğŸ™Š	True
unit	ğŸ‘ª	True
test	ğŸ’¯	True
annoyed	ğŸ˜¾	True
watch	âŒšï¸	True
diners club	ğŸ’³	True
sky	ğŸŒ‘	True
british indian ocean territory flag	ğŸ‡®ğŸ‡´	True
regional indicator symbol letters kh	ğŸ‡°ğŸ‡­	True
large	ğŸ‰	True
kitten	ğŸ±	True
mountain cableway	ğŸš 	True
regional indicator symbol letters bd	ğŸ‡§ğŸ‡©	True
controller	ğŸ®	True
anxious	ğŸ˜“	True
water	ğŸ›	True
cold	ğŸ˜…	True
black and yellow striped sign	ğŸš§	True
bactrian	ğŸ«	True
ouch	ğŸ˜§	True
robot	ğŸ¤–	True
toilet sign	ğŸš»	True
articulated lorry	ğŸš›	True
zodiac	â™Œï¸	True
man with turban	ğŸ‘³	True
raised back of hand	ğŸ¤š	True
take	ğŸ¬	True
regional indicator symbol letters sn	ğŸ‡¸ğŸ‡³	True
bowl	ğŸœ	True
flag for maldives	ğŸ‡²ğŸ‡»	True
railway	ğŸš	True
white sun with small cloud	ğŸŒ¤	True
transportation	ğŸšŠ	True
pakistani flag	ğŸ‡µğŸ‡°	True
pouch	ğŸ‘	True
merchandise	ğŸ¬	True
clear button	ğŸ†‘	True
puppy	ğŸ•	True
water	ğŸƒ	True
miffed	ğŸ˜¾	True
flag for jordan	ğŸ‡¯ğŸ‡´	True
bike	ğŸš²	True
emergency light	ğŸš¨	True
anger symbol	ğŸ’¢	True
stroll	ğŸš·	True
flag for somalia	ğŸ‡¸ğŸ‡´	True
instrument	ğŸ¸	True
keycap number sign	#ï¸âƒ£	True
electronics	ğŸ	True
face with look of triumph	ğŸ˜¤	True
snow	ğŸ¿	True
regional indicator symbol letters nu	ğŸ‡³ğŸ‡º	True
deutsch flag	ğŸ‡©ğŸ‡ª	True
beach	ğŸš	True
detail	ğŸ”	True
south west arrow	â†™ï¸	True
talk	ğŸ’¬	True
burned	ğŸ’¸	True
user	ğŸ‘¥	True
surprise	ğŸ˜²	True
golfer	ğŸŒ	True
space	ğŸŒ	True
transportation	ğŸš	True
tired	ğŸ˜©	True
australian flag	ğŸ‡¦ğŸ‡º	True
flag for united kingdom	ğŸ‡¬ğŸ‡§	True
family of two women with two girls	ğŸ‘©â€ğŸ‘©â€ğŸ‘§â€ğŸ‘§	True
city	ğŸšŒ	True
kiss	ğŸ˜™	True
camera	ğŸ¥	True
black nib	âœ’ï¸	True
fruit	ğŸ’	True
starburst	ğŸ’«	True
stack of books	ğŸ“š	True
transportation	ğŸš	True
vapid	ğŸ˜¶	True
ano niku	ğŸ–	True
oink	ğŸ–	True
japanese	ğŸ™	True
see	ğŸ‘“	True
regional indicator symbol letters kz	ğŸ‡°ğŸ‡¿	True
flag for haiti	ğŸ‡­ğŸ‡¹	True
regional indicator symbol letters mr	ğŸ‡²ğŸ‡·	True
okay	ğŸ†—	True
small blue diamond	ğŸ”¹	True
brown shoe	ğŸ‘	True
animal	ğŸ–	True
night	ğŸŒ•	True
party	ğŸ‰	True
mushroom	ğŸ„	True
fermented	ğŸ·	True
lovestruck	ğŸ’˜	True
house and tree	ğŸ¡	True
oink	ğŸ½	True
smh	ğŸ¤¦	True
greedy	ğŸ–	True
chick	ğŸ¤	True
pray	ğŸ	True
sing	ã€½ï¸	True
ramen	ğŸœ	True
hospital	ğŸ¨	True
cloud	â˜ï¸	True
fried egg	ğŸ³	True
purple heart	ğŸ’œ	True
praise	ğŸ’®	True
flag for ascension island	ğŸ‡¦ğŸ‡¨	True
information	ğŸ’	True
sign	â™Š	True
student	ğŸ’®	True
game	ğŸ´	True
karaoke	ğŸ¤	True
complete	ğŸ	True
celebrate	ğŸ»	True
guard	ğŸ’‚	True
regional indicator symbol letters dm	ğŸ‡©ğŸ‡²	True
zodiac	â™	True
a	ğŸ’¯	True
regional indicator symbol letter g	ğŸ‡¬	True
light brown white down pointing backhand index	ğŸ‘‡ğŸ¼	True
cat	ğŸ˜¿	True
punch	ğŸ’¢	True
dango	ğŸ¡	True
trainer	ğŸ‘Ÿ	True
sad	ğŸ˜­	True
study	ğŸ™€	True
rich	ğŸ¤‘	True
tiredness	ğŸ˜©	True
american flag	ğŸ‡ºğŸ‡¸	True
triangle	ğŸš©	True
japanese flag	ğŸ‡¯ğŸ‡µ	True
heart	ğŸ˜½	True
automobile	ğŸš˜	True
sugar	ğŸ¬	True
spiral calendar pad	ğŸ—“	True
sale	ğŸ’²	True
champagne	ğŸ¾	True
deeper brown dancer	ğŸ’ƒğŸ¾	True
sky	ğŸŒ	True
joystick	ğŸ•¹	True
notice	ğŸ™‹	True
stars	â™Œï¸	True
dumpling	ğŸ¡	True
white medium small square	â—½	True
light brown horse racing	ğŸ‡ğŸ¼	True
www	ğŸŒ	True
music	ğŸ¹	True
like	ğŸ‘	True
frozen	â„ï¸	True
moon	ğŸŒœ	True
heart broken	ğŸ’”	True
regional indicator symbol letters ly	ğŸ‡±ğŸ‡¾	True
black man with turban	ğŸ‘³ğŸ¿	True
white ok hand sign	ğŸ‘ŒğŸ»	True
lollipop	ğŸ­	True
music	ğŸ¼	True
black horse racing	ğŸ‡ğŸ¿	True
flag for french polynesia	ğŸ‡µğŸ‡«	True
octagonal sign	ğŸ›‘	True
elderly woman	ğŸ‘µ	True
bag	ğŸ‘œ	True
locomotive	ğŸš‹	True
girl with crown	ğŸ‘¸	True
magma	ğŸŒ‹	True
yum	ğŸ˜‹	True
spice	ğŸ›	True
bag	ğŸ›…	True
horns	ğŸ	True
cream	ğŸ¨	True
cyclone	ğŸŒ€	True
kadomatsu	ğŸ	True
railway wagon	ğŸšƒ	True
ecuadorian flag	ğŸ‡ªğŸ‡¨	True
slalom	ğŸ¿	True
punch	ğŸ‘Š	True
barber pole	ğŸ’ˆ	True
stars	â™‘	True
glasses	ğŸ‘“	True
exam	ğŸ’¯	True
cloths	ğŸ½	True
soup	ğŸœ	True
asia	ğŸƒ	True
american football	ğŸˆ	True
black large square	â¬›ï¸	True
money	ğŸ’¶	True
tired	ğŸ™€	True
dog paw prints	ğŸ¾	True
cocktail	ğŸ¹	True
candles	ğŸ•	True
military	ğŸ’‚	True
bamboo	ğŸ	True
trumpet	ğŸº	True
food	ğŸ´	True
musical score	ğŸ¼	True
hotdog	ğŸŒ­	True
happy	ğŸ˜‚	True
taurus	â™‰ï¸	True
whisky glass	ğŸ¥ƒ	True
skewer	ğŸ¡	True
kissing cat face with closed eyes	ğŸ˜½	True
wild turkey	ğŸ¦ƒ	True
world tour ticket	ğŸ«	True
puffer	ğŸ¡	True
android lollipop	ğŸ­	True
shell	ğŸš	True
cry	ğŸ˜¢	True
input symbol for symbols	ğŸ”£	True
camping	ğŸ•	True
amaze	ğŸ˜–	True
city	ğŸŒ†	True
transport	ğŸš	True
tree	ğŸŒ¸	True
two hands	ğŸ™Œ	True
smiling	â˜ºï¸	True
phase	ğŸŒš	True
regional indicator symbol letter n	ğŸ‡³	True
footsteps	ğŸ¾	True
officer	ğŸš”	True
stars	â™Š	True
beef	ğŸ„	True
good	ğŸ‘	True
rolodex	ğŸ“‡	True
regional indicator symbol letters jo	ğŸ‡¯ğŸ‡´	True
tram car	ğŸš‹	True
european post office	ğŸ¤	True
tropical	ğŸ	True
lion	â™Œ	True
avian	ğŸ‘º	True
tropical island	ğŸŒ´	True
tomato	ğŸ	True
fax machine	ğŸ“ 	True
egyptian flag	ğŸ‡ªğŸ‡¬	True
car bonnet	ğŸš˜	True
idea	ğŸ’¡	True
regional indicator symbol letters li	ğŸ‡±ğŸ‡®	True
female	ğŸ‘	True
regional indicator symbol letters ss	ğŸ‡¸ğŸ‡¸	True
constellation	â™Œï¸	True
female	ğŸ‘©	True
telescope	ğŸ”­	True
wind	ğŸ’¨	True
ranch	ğŸ 	True
footsteps	ğŸ‘£	True
bus	ğŸšŒ	True
scrunched eyes	ğŸ˜£	True
dessert	ğŸ§	True
fishing rod	ğŸ£	True
white runner	ğŸƒğŸ»	True
prince	ğŸ¤´	True
regional indicator symbol letters sy	ğŸ‡¸ğŸ‡¾	True
trolley	ğŸš	True
royal	ğŸ‘¸	True
merry go round	ğŸ 	True
stallion	ğŸ	True
headdress	ğŸ‘³	True
trash	ğŸš¯	True
cyclist	ğŸš´	True
light brown happy person raising one hand	ğŸ™‹ğŸ¼	True
flag for lithuania	ğŸ‡±ğŸ‡¹	True
drink	ğŸ¸	True
megaphone	ğŸ“£	True
slug	ğŸŒ	True
shadow	ğŸ‘¤	True
santa claus	ğŸ…	True
keycap ten	ğŸ”Ÿ	True
maltese flag	ğŸ‡²ğŸ‡¹	True
alligator	ğŸŠ	True
cash	ğŸ’µ	True
craftsman	ğŸ 	True
hourglass	âŒ›	True
myopia	ğŸ‘“	True
melancholy	ğŸ˜­	True
young	ğŸ¥	True
person with trash	ğŸš®	True
wry	ğŸ˜¼	True
gay couple	ğŸ‘¬	True
spiral	ğŸš	True
yellow heart	ğŸ’›	True
moat	ğŸ°	True
flag for guernsey	ğŸ‡¬ğŸ‡¬	True
blue beam	â˜„	True
downwards black arrow	â¬‡ï¸	True
concerned face	ğŸ˜°	True
flag for vanuatu	ğŸ‡»ğŸ‡º	True
light brown open hands sign	ğŸ‘ğŸ¼	True
regional indicator symbol letters sa	ğŸ‡¸ğŸ‡¦	True
british guardsman	ğŸ’‚	True
strong	ğŸ’ª	True
magic	ğŸ™Œ	True
sprint	ğŸƒ	True
phone	ğŸ“	True
japanese castle	ğŸ¯	True
sleep	ğŸ’¤	True
regional indicator symbol letters md	ğŸ‡²ğŸ‡©	True
game	ğŸ³	True
heavy plus sign	â•	True
spike	ğŸŒµ	True
flag for christmas island	ğŸ‡¨ğŸ‡½	True
front door	ğŸšª	True
daisy	ğŸŒ¼	True
school	ğŸšŒ	True
pub	ğŸ»	True
menorah	ğŸ•	True
gator	ğŸŠ	True
regional indicator symbol letters ky	ğŸ‡°ğŸ‡¾	True
persevere	ğŸ˜£	True
american	ğŸˆ	True
sign of the horns	ğŸ¤˜	True
flag for dominican republic	ğŸ‡©ğŸ‡´	True
flag for belize	ğŸ‡§ğŸ‡¿	True
revolving	ğŸ’	True
bark	ğŸ•	True
clubs	â™£ï¸	True
kiss with two women	ğŸ‘©â€â¤ï¸â€ğŸ’‹â€ğŸ‘©	True
poker machine	ğŸ°	True
regional indicator symbol letters gh	ğŸ‡¬ğŸ‡­	True
accounts	ğŸ‘¥	True
ride	ğŸ	True
racing car	ğŸ	True
pinocchio	ğŸ¤¥	True
north pole	ğŸ…	True
flag for namibia	ğŸ‡³ğŸ‡¦	True
delivery truck	ğŸšš	True
happy	ğŸ˜ƒ	True
tease	ğŸ‘…	True
crowing	ğŸ“	True
grain	ğŸš	True
regional indicator symbol letters lb	ğŸ‡±ğŸ‡§	True
painting	ğŸ™€	True
survivor	ğŸŒ´	True
sky	ğŸŒ	True
thinking bubble	ğŸ’­	True
heart eyes cat	ğŸ˜»	True
helpless face	ğŸ˜£	True
wedding	ğŸ’’	True
rail	ğŸšƒ	True
house building	ğŸ 	True
sport stadium	ğŸŸ	True
myself	ğŸ‘¤	True
holiday inn	ğŸ¨	True
mask	ğŸ˜·	True
flag for tuvalu	ğŸ‡¹ğŸ‡»	True
back	ğŸ”™	True
highway	ğŸ›£	True
golden gate bridge	ğŸŒ‰	True
sheep	ğŸ‘	True
strawberry	ğŸ°	True
glowing star	ğŸŒŸ	True
teacher	ğŸ	True
tramway	ğŸš¡	True
å‰²	ğŸˆ¹	True
mouse with whiskers	ğŸ­	True
direct	ğŸ¯	True
regional indicator symbol letters tz	ğŸ‡¹ğŸ‡¿	True
malt	ğŸº	True
speed	ğŸš¤	True
twins	â™Šï¸	True
wind	ğŸ	True
red lantern	ğŸ®	True
park	â›²	True
family	ğŸ‘ª	True
djiboutian flag	ğŸ‡©ğŸ‡¯	True
carve	ğŸƒ	True
flag for european union	ğŸ‡ªğŸ‡º	True
baby	ğŸ‘¶	True
robot face	ğŸ˜‘	True
bills	ğŸ’·	True
beers	ğŸ»	True
regional indicator symbol letter e	ğŸ‡ª	True
panda face	ğŸ¼	True
farm	ğŸšœ	True
safety helmet	ğŸ‘·	True
black ant	ğŸœ	True
cowboy	ğŸ	True
yellow	ğŸŒ½	True
top with upwards arrow above	ğŸ”	True
cheeks	ğŸ˜³	True
wash	ğŸš¿	True
degree	ğŸ“œ	True
throne	ğŸš½	True
poultry	ğŸ—	True
love	ğŸ˜š	True
phase	ğŸŒ™	True
bag	ğŸ‘	True
regional indicator symbol letters za	ğŸ‡¿ğŸ‡¦	True
regional indicator symbol letters lc	ğŸ‡±ğŸ‡¨	True
massive	ğŸ‹	True
sleepy	ğŸ˜´	True
ski	ğŸ¿	True
slightly happy	ğŸ™‚	True
scape	ğŸŒ†	True
ballonfish	ğŸ¡	True
yawning	ğŸ˜¦	True
speaker	ğŸ”ˆ	True
artist palette	ğŸ¨	True
double curly loop	â¿	True
understanding	ğŸ’œ	True
black nose	ğŸ‘ƒğŸ¿	True
pager	ğŸ“Ÿ	True
light brown information desk person	ğŸ’ğŸ¼	True
spotted	ğŸ†	True
westerner	ğŸ‘±	True
brokenhearted	ğŸ’”	True
olive toned information desk person	ğŸ’ğŸ½	True
baby bottle	ğŸ¼	True
disappointed face	ğŸ˜	True
crossed flags	ğŸŒ	True
light brown face with ok gesture	ğŸ™†ğŸ¼	True
speaking	ğŸ‘„	True
planet	ğŸŒ	True
italy	ğŸ•	True
clock face ten oclock	ğŸ•™	True
communication	ğŸ’¬	True
stargazing	ğŸ”­	True
light brown person frowning	ğŸ™ğŸ¼	True
weary	ğŸ™€	True
white older woman	ğŸ‘µğŸ»	True
british flag	ğŸ‡¬ğŸ‡§	True
gas	â›½	True
radical 74	ğŸˆ·ï¸	True
white baby	ğŸ‘¶ğŸ»	True
lowercase	ğŸ”¡	True
boy	ğŸ‘ª	True
astrology	â™‘ï¸	True
light brown man with gua pi mao	ğŸ‘²ğŸ¼	True
black square for stop	â¹	True
silly	ğŸ’	True
reminder ribbon	ğŸ—	True
wedding bell	ğŸ””	True
blowing wind	ğŸŒ¬	True
antenna with bars	ğŸ“¶	True
regional indicator symbol letters jm	ğŸ‡¯ğŸ‡²	True
ship	âš“ï¸	True
person with ball	â›¹	True
loudly crying face	ğŸ˜­	True
cheeky monkey	ğŸ’	True
head	ğŸ²	True
cross	â›ª	True
large red circle	ğŸ”´	True
motorhome	ğŸš™	True
æœ‰	ğŸˆ¶	True
cloud with snow	ğŸŒ¨	True
baby symbol	ğŸš¼	True
megabyte	ğŸ’¾	True
green book	ğŸ“—	True
snowman	â˜ƒ	True
floppy disk	ğŸ’¾	True
first quarter moon with face	ğŸŒ›	True
pile of poo	ğŸ’©	True
gay pride	ğŸŒˆ	True
walking	ğŸš¶	True
white haircut	ğŸ’‡ğŸ»	True
shark	ğŸ¦ˆ	True
flag for slovakia	ğŸ‡¸ğŸ‡°	True
pouting cat face	ğŸ˜¾	True
cheese	ğŸ§€	True
melancholy	ğŸ˜¿	True
straight couple	ğŸ‘«	True
bowing man	ğŸ™‡	True
boat	ğŸš£	True
astrology	â™ï¸	True
queen	ğŸ	True
flag for poland	ğŸ‡µğŸ‡±	True
funeral urn	âš±	True
colt	ğŸ	True
regional indicator symbol letters gw	ğŸ‡¬ğŸ‡¼	True
flag for singapore	ğŸ‡¸ğŸ‡¬	True
regional indicator symbol letters sv	ğŸ‡¸ğŸ‡»	True
male dancer	ğŸ•º	True
deeper brown bicyclist	ğŸš´ğŸ¾	True
empty bathtub	ğŸ›	True
letter	ã€½ï¸	True
flag for guyana	ğŸ‡¬ğŸ‡¾	True
gelding	ğŸ	True
gold	ğŸ’›	True
family of two women with one girl	ğŸ‘©â€ğŸ‘©â€ğŸ‘§	True
pit	ğŸ‘	True
awkward	ğŸ˜¬	True
nut	ğŸŒ°	True
teach	ğŸ«	True
donut	ğŸ©	True
clock face one oclock	ğŸ•	True
heart	ğŸ’š	True
horse head	ğŸ´	True
ears	ğŸ‘‚	True
smartphone	ğŸ“±	True
toilet	ğŸš»	True
red car	ğŸš—	True
moon	ğŸŒ™	True
go	ğŸš¦	True
skewer	ğŸ¢	True
think	ğŸ˜”	True
italian	ğŸ…	True
light brown father christmas	ğŸ…ğŸ¼	True
grumpy cat	ğŸ˜¾	True
flag for diego garcia	ğŸ‡©ğŸ‡¬	True
watermelon	ğŸ‰	True
index card	ğŸ“‡	True
steam	â™¨ï¸	True
shampoo	ğŸš¿	True
ecstatic	ğŸ˜	True
stairs	ğŸ“¶	True
aa battery	ğŸ”‹	True
love letter	ğŸ’Œ	True
tears	ğŸ˜­	True
tengu	ğŸ‘º	True
friendship	ğŸ’›	True
xbox	ğŸ®	True
delivery	ğŸšš	True
crescent	ğŸŒ˜	True
spaghetti	ğŸ	True
chili pepper	ğŸŒ¶	True
meal	ğŸ›	True
fishing pole and fish	ğŸ£	True
spiral note pad	ğŸ—’	True
night	ğŸŒ‘	True
face massage	ğŸ’†	True
curaÃ§aoan flag	ğŸ‡¨ğŸ‡¼	True
verbal	ğŸ™Š	True
leaf fluttering in wind	ğŸƒ	True
needles	ğŸŒ²	True
white person with blond hair	ğŸ‘±ğŸ»	True
family of two men with two girls	ğŸ‘¨â€ğŸ‘¨â€ğŸ‘§â€ğŸ‘§	True
me	ğŸ‘¤	True
flag for niue	ğŸ‡³ğŸ‡º	True
slightly frowning face	ğŸ™	True
boom	ğŸ’¥	True
notebook with decorative cover	ğŸ“”	True
guardsman	ğŸ’‚	True
feline	ğŸˆ	True
sausage	ğŸŒ­	True
flag for curaÃ§ao	ğŸ‡¨ğŸ‡¼	True
void	ğŸ˜‘	True
deeper brown face with no good gesture	ğŸ™…ğŸ¾	True
accessible bathroom	â™¿	True
green truck	ğŸš›	True
constellation	â™ï¸	True
chinese flag	ğŸ‡¨ğŸ‡³	True
stave	ğŸ¼	True
lion	ğŸ¾	True
attention	ğŸ™‹	True
alarm clock	â°	True
kissing	ğŸ˜™	True
freestyle	ğŸ‚	True
costume	ğŸƒ	True
tear	ğŸ˜¢	True
cancer	ğŸš­	True
big top	ğŸª	True
purchase	ğŸ’³	True
well done stamp	ğŸ’®	True
food	ğŸ›	True
black spade suit	â™ ï¸	True
horse racing	ğŸ‡	True
flag for estonia	ğŸ‡ªğŸ‡ª	True
regional indicator symbol letters id	ğŸ‡®ğŸ‡©	True
fat	ğŸ‹	True
flag for laos	ğŸ‡±ğŸ‡¦	True
home	ğŸŒ	True
sniffing	ğŸ‘ƒ	True
babe	ğŸš¼	True
silliness	ğŸ‘…	True
flag for costa rica	ğŸ‡¨ğŸ‡·	True
pisces	â™“ï¸	True
banknote	ğŸ’¶	True
theater	ğŸ‘º	True
bearer	â™’	True
incoming envelope	ğŸ“¨	True
friends	ğŸ‘­	True
december	ğŸ„	True
star and crescent	â˜ª	True
ears	ğŸ™‰	True
single bump camel	ğŸª	True
light brown bath	ğŸ›€ğŸ¼	True
train	ğŸš 	True
cherries	ğŸ’	True
white white up pointing backhand index	ğŸ‘†ğŸ»	True
department	ğŸ¬	True
freezing	ğŸ˜	True
red	â¤ï¸	True
video game monster	ğŸ‘¾	True
cherry	ğŸŒ¸	True
mountain	ğŸš	True
flag for jersey	ğŸ‡¯ğŸ‡ª	True
ball	ğŸ¾	True
drink	ğŸ®	True
monorail	ğŸš	True
office building	ğŸ¢	True
thought	ğŸ’­	True
chart with upwards trend	ğŸ“ˆ	True
nerdy	ğŸ¤“	True
pile	ğŸ’©	True
flag for yemen	ğŸ‡¾ğŸ‡ª	True
flag for peru	ğŸ‡µğŸ‡ª	True
thumb	ğŸ‘	True
ballot box with check	â˜‘ï¸	True
kenyan flag	ğŸ‡°ğŸ‡ª	True
celebration	ğŸ¥‚	True
metro	ğŸš‡	True
celebrate	ğŸ’ƒ	True
festivus miracle	ğŸ™Œ	True
blue	ğŸ‘–	True
tree	ğŸŒ²	True
halo	ğŸ‘¼	True
run	ğŸ½	True
flag for spain	ğŸ‡ªğŸ‡¸	True
post office	ğŸ¤	True
panda	ğŸ¼	True
flag for togo	ğŸ‡¹ğŸ‡¬	True
computer	ğŸ’¾	True
keycap digit five	5ï¸âƒ£	True
white person raising both hands in celebration	ğŸ™ŒğŸ»	True
girl	ğŸšº	True
helicopter	ğŸš	True
zodiac	â™ˆï¸	True
desert island	ğŸ	True
car	ğŸš”	True
game	ğŸ¾	True
fire tag	ğŸ“›	True
pink shirt	ğŸ‘š	True
clinking glasses	ğŸ¥‚	True
hibiscus	ğŸŒº	True
sulk	ğŸ˜¦	True
children crossing	ğŸš¸	True
bullock	ğŸ‚	True
white	ğŸ™	True
rude finger	ğŸ–•	True
ride	ğŸ¡	True
waving	ğŸ‘‹	True
flag for mexico	ğŸ‡²ğŸ‡½	True
tired	ğŸ˜«	True
moo	ğŸ„	True
tie	ğŸ‘”	True
disco dancer	ğŸ•º	True
correct	â­•	True
cob	ğŸŒ½	True
cop	ğŸ‘®	True
soccer ball	âš½ï¸	True
regional indicator symbol letters de	ğŸ‡©ğŸ‡ª	True
olive toned surfer	ğŸ„ğŸ½	True
flag for iceland	ğŸ‡®ğŸ‡¸	True
scream	ğŸ˜±	True
newspaper delivery	ğŸ—	True
closed lock	ğŸ”’	True
black ear	ğŸ‘‚ğŸ¿	True
alphabet	ğŸ”¤	True
honeydew	ğŸˆ	True
unicorn	ğŸ¦„	True
impish	ğŸ˜ˆ	True
gun	ğŸ”«	True
feet	ğŸ‘£	True
cow	ğŸ	True
nearsightedness	ğŸ‘“	True
beach	ğŸŒŠ	True
cash	ğŸ’¶	True
electric	ğŸ¹	True
white boy	ğŸ‘¦ğŸ»	True
car	ğŸš“	True
pool	ğŸ±	True
human	ğŸš¼	True
explode	ğŸ’¥	True
lovestruck	ğŸ˜»	True
leaf	ğŸ‚	True
dart	ğŸ¯	True
father christmas	ğŸ…	True
smell	ğŸ½	True
new	ğŸŒ±	True
star	ğŸŒ 	True
beaver	ğŸ©	True
birthday	ğŸŠ	True
rail	ğŸš‹	True
bride	ğŸ‘°	True
family of two men with one girl and one boy	ğŸ‘¨â€ğŸ‘¨â€ğŸ‘§â€ğŸ‘¦	True
running shirt with sash	ğŸ½	True
roast turkey	ğŸ¦ƒ	True
loop	â°	True
sob	ğŸ˜¿	True
feet	ğŸ¾	True
pumpkin	ğŸƒ	True
flag for nicaragua	ğŸ‡³ğŸ‡®	True
heart	ğŸ’™	True
negative squared cross mark	â	True
person with folded hands	ğŸ™	True
pig snout	ğŸ½	True
black large square	â¬›	True
old lady	ğŸ‘µ	True
twisted rightwards arrows	ğŸ”€	True
no people	ğŸš·	True
checkered	ğŸ	True
deeper brown face with ok gesture	ğŸ™†ğŸ¾	True
request	ğŸˆ¸	True
regional indicator symbol letters tf	ğŸ‡¹ğŸ‡«	True
collapsed umbrella	ğŸŒ‚	True
exhausted	ğŸ˜ª	True
shining star	ğŸŒŸ	True
torch	ğŸ”¦	True
mens toilet	ğŸš¹	True
bull	â™‰ï¸	True
surgical mask	ğŸ˜·	True
open mouth	ğŸ˜®	True
silly	ğŸ™ƒ	True
dessert	ğŸ°	True
greek	â™ï¸	True
digital radio	ğŸ“»	True
tongue face	ğŸ˜›	True
travel	ğŸ›„	True
black medium small square	â—¾ï¸	True
alpine	ğŸ¿	True
astrology	â™Œï¸	True
taste	ğŸ‘…	True
girl	ğŸ‘§	True
baby angel	ğŸ‘¼	True
toddler	ğŸ‘¶	True
team	ğŸ‰	True
racket	ğŸ¾	True
smiling face with horns	ğŸ˜ˆ	True
sign	â™ï¸	True
olive toned open hands sign	ğŸ‘ğŸ½	True
canadian	ğŸ	True
flag for montserrat	ğŸ‡²ğŸ‡¸	True
front of bus	ğŸš	True
light brown pedestrian	ğŸš¶ğŸ¼	True
funeral	âš°	True
flag for djibouti	ğŸ‡©ğŸ‡¯	True
trade mark sign	â„¢ï¸	True
playful	ğŸ‘…	True
eu flag	ğŸ‡ªğŸ‡º	True
card index	ğŸ“‡	True
frosty the snowman	â›„	True
100	ğŸ’¯	True
soak	ğŸ›€	True
deciduous	ğŸŒ³	True
makeup	ğŸ‘	True
detective	ğŸ”	True
dash symbol	ğŸ’¨	True
up	ğŸ‘	True
bowl	ğŸš	True
fly	âœˆï¸	True
put litter in its place symbol	ğŸš®	True
europe	ğŸ’¶	True
foreign	ğŸ›‚	True
malaysian flag	ğŸ‡²ğŸ‡¾	True
squared new	ğŸ†•	True
medal	ğŸ–	True
cross mark	âŒ	True
military medal	ğŸ–	True
rail	ğŸš†	True
gallery	ğŸ–¼	True
constellation	â™	True
input symbol for latin letters	ğŸ”¤	True
iwazaru	ğŸ™Š	True
horizontal	ğŸš¥	True
muscle	ğŸ’ª	True
herb	ğŸŒ¿	True
sign	â™	True
smiley face	ğŸ˜„	True
dolls	ğŸ	True
usa flag	ğŸ‡ºğŸ‡¸	True
rocket	ğŸ†	True
bumble	ğŸ	True
star	ğŸ‹	True
blonde girl	ğŸ‘¸	True
cry	ğŸ˜¹	True
leaves	ğŸƒ	True
euro	ğŸ’¶	True
flag in hole	â›³	True
constellation	â™ˆï¸	True
heart	ğŸ’	True
zodiac	â™ï¸	True
eek	ğŸ˜¬	True
smiling	ğŸ˜Š	True
swirl	ğŸŒ€	True
sushi	ğŸ¡	True
floppy	ğŸ’¾	True
medical	ğŸš‘	True
gross	ğŸš±	True
package	ğŸ	True
kiss	ğŸ˜š	True
mouse	ğŸ­	True
blushing face	ğŸ˜³	True
insect	ğŸœ	True
moisture	ğŸŒ‚	True
wrench	ğŸ”§	True
tokyo tower	ğŸ—¼	True
appreciation	ğŸ‘	True
dollar	ğŸ’µ	True
fed up	ğŸ™	True
hitting head	ğŸ¤¦	True
red tower	ğŸ—¼	True
sacrifice	ğŸ’œ	True
clock face twelve oclock	ğŸ•›	True
special	ğŸ´	True
zodiac	â™Šï¸	True
fast	ğŸ’¨	True
zodiac	â™‘	True
stop	ğŸš«	True
withdrawal	ğŸ§	True
red wine	ğŸ·	True
keycap digit three	3ï¸âƒ£	True
chick	ğŸ¥	True
light brown person raising both hands in celebration	ğŸ™ŒğŸ¼	True
jeans	ğŸ‘–	True
grief	ğŸ˜§	True
thank you	ğŸ™	True
wolf face	ğŸº	True
canada	ğŸ	True
regional indicator symbol letters cl	ğŸ‡¨ğŸ‡±	True
fortified	ğŸ¯	True
black haircut	ğŸ’‡ğŸ¿	True
transportation	ğŸšµ	True
ultraviolet	ğŸŒ‚	True
extraterrestrial alien	ğŸ‘½	True
flag for russia	ğŸ‡·ğŸ‡º	True
detail	ğŸ”	True
flag for lesotho	ğŸ‡±ğŸ‡¸	True
travel	ğŸ›…	True
question	ğŸ’	True
regional indicator symbol letters mg	ğŸ‡²ğŸ‡¬	True
angel	ğŸ˜‡	True
regular train	ğŸš†	True
high	ğŸ«	True
constellation	â™’	True
buds	ğŸ‘…	True
passion	ğŸ˜½	True
puzzle	ğŸ˜•	True
apple times	ğŸ“°	True
place of worship	ğŸ›	True
aries	â™ˆï¸	True
power	ğŸš¤	True
railway	ğŸšŸ	True
square	ğŸ“	True
deeper brown waving hand sign	ğŸ‘‹ğŸ¾	True
circle arrows with number 1	ğŸ”‚	True
flag for albania	ğŸ‡¦ğŸ‡±	True
fungi	ğŸ„	True
anguish	ğŸ˜§	True
regional indicator symbol letters be	ğŸ‡§ğŸ‡ª	True
sad sweat face	ğŸ˜“	True
black sun with rays	â˜€ï¸	True
monkey	ğŸ™ˆ	True
help	ğŸš“	True
lord	ğŸ°	True
queen	ğŸ‘¸	True
regional indicator symbol letters ir	ğŸ‡®ğŸ‡·	True
fair	ğŸ¡	True
jogging	ğŸƒ	True
train	ğŸš„	True
fire engine	ğŸš’	True
soft	ğŸ¨	True
biohazard sign	â˜£	True
croc	ğŸŠ	True
sensitive	ğŸ’œ	True
ballet	ğŸ‘¯	True
regional indicator symbol letters bw	ğŸ‡§ğŸ‡¼	True
celebrate	ğŸŠ	True
triple crown	ğŸ‡	True
bottle	ğŸ¼	True
frown	ğŸ˜¦	True
fort	ğŸ¯	True
puppy	ğŸ¶	True
freestyle	ğŸŠ	True
flag for sudan	ğŸ‡¸ğŸ‡©	True
spider web	ğŸ•¸	True
wedding	ğŸ‘°	True
dark moon face	ğŸŒš	True
arrow	ğŸ¯	True
festival	ğŸ‹	True
no one under eighteen symbol	ğŸ”	True
table tennis	ğŸ“	True
japan	ğŸ	True
palm	ğŸŒ´	True
baby	ğŸ£	True
on with exclamation mark with left right arrow above	ğŸ”›	True
clear	ğŸš°	True
sad	ğŸ˜¦	True
compassionate	ğŸ’›	True
fruit	ğŸ	True
moist	ğŸ’§	True
constellation	â™‰	True
golf flag	â›³	True
gay men	ğŸ‘¬	True
light	ğŸš¥	True
german flag	ğŸ‡©ğŸ‡ª	True
winking face	ğŸ˜‰	True
japanese akita	ğŸ•	True
sleepy	ğŸ™€	True
citrus	ğŸŠ	True
badminton racquet and shuttlecock	ğŸ¸	True
stars	â™“ï¸	True
regional indicator symbol letters ai	ğŸ‡¦ğŸ‡®	True
light beam	â˜„	True
hug	ğŸ¤—	True
stars	â™Šï¸	True
ç©º	ğŸˆ³	True
spend	ğŸ’¸	True
flan	ğŸ®	True
child	ğŸ‘ª	True
coffee	â˜•	True
nerd face	ğŸ¤“	True
Ã¥land flag	ğŸ‡¦ğŸ‡½	True
regional indicator symbol letters bm	ğŸ‡§ğŸ‡²	True
pit	ğŸ’	True
shrimp	ğŸ¤	True
deeper brown older woman	ğŸ‘µğŸ¾	True
distressed	ğŸ˜Ÿ	True
space	ğŸŒŒ	True
popcorn	ğŸŒ½	True
plant	ğŸŒ¾	True
chanukiah	ğŸ•	True
european	âš½ï¸	True
points	ğŸŒŸ	True
black information desk person	ğŸ’ğŸ¿	True
guest	ğŸ‘¤	True
red	ğŸ˜³	True
first quarter moon symbol	ğŸŒ“	True
regional indicator symbol letters py	ğŸ‡µğŸ‡¾	True
flag for northern mariana islands	ğŸ‡²ğŸ‡µ	True
smile	ğŸ˜„	True
sunrise	ğŸŒ‡	True
tub	ğŸ›€	True
woman	ğŸ‘š	True
spiral shell	ğŸš	True
road	ğŸ›£	True
pleased	ğŸ˜Œ	True
domed roof	ğŸ•Œ	True
fruit	ğŸ†	True
help	ğŸš‘	True
holding hands	ğŸ‘«	True
clock face six oclock	ğŸ••	True
no	ğŸš·	True
no	ğŸš­	True
cat	ğŸ˜º	True
deciduous	ğŸ‚	True
please	ğŸ™	True
woot	ğŸ™Œ	True
writing hand	âœ	True
smile	ğŸ˜ƒ	True
moon	ğŸŒš	True
flag for falkland islands	ğŸ‡«ğŸ‡°	True
large blue circle	ğŸ”µ	True
drunk	ğŸ’«	True
bowl	ğŸ³	True
holiday	ğŸ„	True
demon	ğŸ‘¹	True
rocket ship	ğŸš€	True
file folder	ğŸ“	True
peperoni	ğŸ•	True
college	ğŸ«	True
deeper brown baby angel	ğŸ‘¼ğŸ¾	True
globe	ğŸŒ	True
love	ğŸ˜»	True
verbalize	ğŸ™Š	True
input symbol for latin capital letters	ğŸ” 	True
laughing cat	ğŸ˜¹	True
vibration mode	ğŸ“³	True
camcorder	ğŸ“¹	True
no pedestrians	ğŸš·	True
arrow pointing rightwards then curving downwards	â¤µï¸	True
chocolate bar	ğŸ«	True
grin	ğŸ˜¸	True
copyright sign	Â©ï¸	True
acquire	ğŸ‰	True
ski and ski boot	ğŸ¿	True
thermometer	ğŸŒ¡	True
neutral face	ğŸ˜	True
home	ğŸŒ	True
heterosexual couple	ğŸ‘«	True
housecat	ğŸˆ	True
deeper brown man with gua pi mao	ğŸ‘²ğŸ¾	True
bed	ğŸ›	True
phase	ğŸŒ•	True
assistance	ğŸš‘	True
happy cat	ğŸ˜¸	True
sauce	ğŸ…	True
fisted hand sign	ğŸ‘Š	True
homosexual	ğŸ‘¬	True
double curling loop	â¿	True
frying	ğŸ³	True
clear	ğŸ†‘	True
skis	ğŸ¿	True
evening	ğŸŒ‰	True
lips	ğŸ˜™	True
follower	ğŸ‘	True
cd rom	ğŸ’¿	True
earth	ğŸŒ	True
silhouette	ğŸ‘¤	True
hungry	ğŸ˜‹	True
showgirl	ğŸ‘¯	True
light	ğŸš¦	True
pizza	ğŸ•	True
academic	ğŸ“	True
regional indicator symbol letter v	ğŸ‡»	True
dirty	ğŸš±	True
pink swirl	ğŸ¥	True
revolver	ğŸ”«	True
regional indicator symbol letters co	ğŸ‡¨ğŸ‡´	True
new moon with face	ğŸŒš	True
prosperity	ğŸ	True
white fisted hand sign	ğŸ‘ŠğŸ»	True
shew stone	ğŸ”®	True
intimacy	ğŸ‘…	True
price tag	ğŸ”–	True
unicorn face	ğŸ¦„	True
flying money	ğŸ’¸	True
yellow flower	ğŸŒ»	True
big	ğŸª	True
bowling ball	ğŸ³	True
flag for united arab emirates	ğŸ‡¦ğŸ‡ª	True
virgo	â™ï¸	True
dove of peace	ğŸ•Š	True
light brown dancer	ğŸ’ƒğŸ¼	True
officer	ğŸš“	True
happy	ğŸ’›	True
black waving hand sign	ğŸ‘‹ğŸ¿	True
christmas tree	ğŸ„	True
money face	ğŸ¤‘	True
clumsy	ğŸ¤•	True
jealous heart	ğŸ’š	True
abc	ğŸ”¤	True
ghanaian flag	ğŸ‡¬ğŸ‡­	True
sexy	ğŸ†	True
regional indicator symbol letters mo	ğŸ‡²ğŸ‡´	True
tree	ğŸ	True
champagne glasses	ğŸ¥‚	True
anger sign	ğŸ’¢	True
phase	ğŸŒ”	True
derelict house building	ğŸš	True
announcement	ğŸ“¢	True
dawn	ğŸŒ‡	True
greek	â™ˆï¸	True
face with hat	ğŸ‘·	True
regional indicator symbol letters ec	ğŸ‡ªğŸ‡¨	True
bag	ğŸ‘›	True
expressionless face	ğŸ˜‘	True
cheers	ğŸ¥‚	True
regional indicator symbol letters bg	ğŸ‡§ğŸ‡¬	True
bridge	ğŸŒ‰	True
ice hockey stick and puck	ğŸ’	True
bull	â™‰	True
bike	ğŸš´	True
padlock	ğŸ”’	True
bullet train	ğŸš…	True
foot in mouth	ğŸ˜¬	True
flag for san marino	ğŸ‡¸ğŸ‡²	True
drink	ğŸµ	True
needle	ğŸ’‰	True
women	ğŸ‘­	True
french guinean flag	ğŸ‡¬ğŸ‡«	True
gapping	ğŸ˜®	True
claw hammer	ğŸ”¨	True
sign	â™ï¸	True
spiral eyes face	ğŸ˜µ	True
white flower	ğŸ’®	True
waxing crescent moon symbol	ğŸŒ’	True
motorbike	ğŸ	True
bathroom	ğŸš»	True
inbox tray	ğŸ“¥	True
box	ğŸ±	True
wavy dash	ã€°ï¸	True
rodent	ğŸ	True
deeper brown raised hand with part between middle and ring fingers	ğŸ––ğŸ¾	True
hot weather	ğŸŒ¡	True
increase brightness	ğŸ”†	True
level slider	ğŸš	True
berry	ğŸ“	True
white question mark ornament	â”	True
sad person	ğŸ™	True
family of a man and woman with one girl	ğŸ‘¨â€ğŸ‘©â€ğŸ‘§	True
yummy	ğŸ˜‹	True
north east arrow	â†—ï¸	True
phew	ğŸ˜Œ	True
bedtime	ğŸ’¤	True
frown	ğŸ‘º	True
peace sign	âœŒï¸	True
pina	ğŸ	True
greek	â™‰ï¸	True
musical	ğŸµ	True
performing	ğŸ­	True
loop once symbol	ğŸ”‚	True
shopping	ğŸ‘›	True
wheelchair symbol	â™¿	True
mountain	ğŸ‚	True
splashing sweat symbol	ğŸ’¦	True
white bicyclist	ğŸš´ğŸ»	True
shooting	ğŸŒ 	True
parents with child	ğŸ‘ª	True
italian	ğŸ•	True
teacup	ğŸµ	True
union	ğŸ‰	True
hobs	ğŸ…	True
regional indicator symbol letters tt	ğŸ‡¹ğŸ‡¹	True
menorah with nine branches	ğŸ•	True
laughing	ğŸ˜†	True
wind chime	ğŸ	True
shipyard	âš“ï¸	True
anchor	âš“	True
rise	ğŸŒ‡	True
fruit punch	ğŸ¹	True
oil drum	ğŸ›¢	True
olive toned person with blond hair	ğŸ‘±ğŸ½	True
flag for uzbekistan	ğŸ‡ºğŸ‡¿	True
regional indicator symbol letters iq	ğŸ‡®ğŸ‡¶	True
regret	ğŸ™	True
smile	ğŸ˜™	True
speech	ğŸ’¬	True
banknote with pound sign	ğŸ’·	True
input symbol for latin small letters	ğŸ”¡	True
regional indicator symbol letters in	ğŸ‡®ğŸ‡³	True
black open hands sign	ğŸ‘ğŸ¿	True
book	ğŸ“–	True
regional indicator symbol letters to	ğŸ‡¹ğŸ‡´	True
white waving hand sign	ğŸ‘‹ğŸ»	True
story	ğŸ­	True
red	ğŸ	True
amex	ğŸ’³	True
bicycle	ğŸš³	True
flower	ğŸ	True
morn	ğŸ˜¿	True
hammer and pick	âš’	True
school	ğŸš	True
level up	ğŸ†™	True
sagittarius	â™	True
chart with downwards trend	ğŸ“‰	True
minaret	ğŸ•Œ	True
hearts	ğŸ’•	True
caring	ğŸ’›	True
twenty quid note	ğŸ’·	True
mixed	ğŸ¹	True
litter	ğŸš®	True
old man	ğŸ‘´	True
sun	ğŸŒ»	True
royal	ğŸ‘‘	True
olive toned guardsman	ğŸ’‚ğŸ½	True
year of the horse	ğŸ	True
elephant	ğŸ˜	True
pine	ğŸ	True
triple heart	ğŸ’—	True
vulcan salute	ğŸ––	True
eject symbol	â	True
deeper brown man	ğŸ‘¨ğŸ¾	True
money	ğŸ‘›	True
night sky	ğŸŒŒ	True
deeper brown person raising both hands in celebration	ğŸ™ŒğŸ¾	True
soup	ğŸ²	True
money with wings	ğŸ’¸	True
snowing	â„ï¸	True
pink bow	ğŸ€	True
christmas	ğŸ„	True
bulgarian flag	ğŸ‡§ğŸ‡¬	True
cooking	ğŸŒ¿	True
last	ğŸŒ—	True
sparkling heart	ğŸ’–	True
nanna	ğŸ‘µ	True
bass guitar	ğŸ¸	True
presents	ğŸ…	True
sleepy	ğŸ˜ª	True
foggy city	ğŸŒ	True
muslim	ğŸ‘³	True
asian	ğŸ‘²	True
wine	ğŸ·	True
quarter	ğŸŒœ	True
automobile	ğŸš—	True
flavoring	ğŸ§	True
martini glass	ğŸ¸	True
autumn	ğŸ‚	True
zzz	ğŸ’¤	True
pickle	ğŸ¥’	True
magnify	ğŸ”¬	True
restriction	ğŸš«	True
harvest moon	ğŸ‘	True
flag for georgia	ğŸ‡¬ğŸ‡ª	True
left right arrow	â†”ï¸	True
middle east	ğŸª	True
regional indicator symbol letters ck	ğŸ‡¨ğŸ‡°	True
heart eyes	ğŸ˜	True
tornado	ğŸŒ€	True
woman with bunny ears	ğŸ‘¯	True
black thumbs down sign	ğŸ‘ğŸ¿	True
crab cancer	ğŸ¦€	True
film frames	ğŸ	True
womens toilet	ğŸšº	True
grumpy face	ğŸ˜¡	True
galloping horse	ğŸ	True
clammy	ğŸ˜“	True
indian camel	ğŸª	True
front of taxi	ğŸš–	True
meat	ğŸ”	True
pc tower	ğŸ–¥	True
face	ğŸŒ	True
squared id	ğŸ†”	True
cap	ğŸ“	True
flagpole	ğŸš©	True
stars	â™ˆï¸	True
engine	ğŸš‚	True
stop sign	ğŸ›‘	True
jaw	ğŸ˜®	True
money	ğŸ’µ	True
waning gibbous moon symbol	ğŸŒ–	True
nut and bolt	ğŸ”©	True
power plug	ğŸ”Œ	True
flag for kuwait	ğŸ‡°ğŸ‡¼	True
sex	ğŸ©	True
white	ğŸ¼	True
underground	ğŸš‡	True
dollar	ğŸ’¸	True
beats	ğŸ§	True
ng	ğŸ†–	True
skirt	ğŸ‘—	True
waves	ğŸŒŠ	True
subway	ğŸš‰	True
stars	â™ï¸	True
birthday present	ğŸ	True
can	ğŸš®	True
cranky	ğŸŠ	True
regional indicator symbol letters mp	ğŸ‡²ğŸ‡µ	True
astrology	â™‹	True
party popper	ğŸ‰	True
banknote with euro sign	ğŸ’¶	True
transportation	ğŸš´	True
shopping	ğŸ’³	True
flag for marshall islands	ğŸ‡²ğŸ‡­	True
pot	ğŸ²	True
cantaloupe	ğŸˆ	True
french kiss	ğŸ‘…	True
surprised face	ğŸ˜¯	True
butterfly	ğŸ¦‹	True
eyes	ğŸ™ˆ	True
formal wear	ğŸ©	True
litter	ğŸš¯	True
name tag	ğŸ“›	True
love heart hotel	ğŸ©	True
sax	ğŸ·	True
dumplings and moon	ğŸ‘	True
period piece	ğŸ©	True
moving	ğŸ’	True
astrology	â™“ï¸	True
shell	ğŸ¢	True
truffle	ğŸ½	True
dark	ğŸŒ†	True
heart	ğŸ’›	True
deeper brown flexed biceps	ğŸ’ªğŸ¾	True
â„¹ help icon	â„¹ï¸	True
music	ğŸµ	True
roadwork sign	ğŸš§	True
alcohol	ğŸ¶	True
smiling moon	ğŸŒ	True
playstation	ğŸ®	True
flag for bermuda	ğŸ‡§ğŸ‡²	True
manx flag	ğŸ‡®ğŸ‡²	True
raw	ğŸ£	True
flag for chad	ğŸ‡¹ğŸ‡©	True
sign	â™“ï¸	True
blank face	ğŸ˜¶	True
pie	ğŸ	True
fruit	ğŸ‰	True
iowa	ğŸŒ½	True
train and mountain	ğŸš	True
shops	ğŸ¬	True
bus	ğŸš	True
drunk	ğŸ˜µ	True
avatar	ğŸšº	True
australia	ğŸŒ	True
regional indicator symbol letters cw	ğŸ‡¨ğŸ‡¼	True
abcd	ğŸ” 	True
aeroplane	âœˆï¸	True
crying cat face	ğŸ˜¿	True
family of two men with two boys	ğŸ‘¨â€ğŸ‘¨â€ğŸ‘¦â€ğŸ‘¦	True
æœˆ	ğŸˆ·ï¸	True
lady bug	ğŸ	True
japanese	ğŸ˜	True
olive toned man	ğŸ‘¨ğŸ½	True
snore	ğŸ˜´	True
perfect	ğŸ‘Œ	True
zodiac	â™‰ï¸	True
stars	â™‰ï¸	True
world	ğŸŒ	True
handbag	ğŸ‘œ	True
purple goblin	ğŸ‘¿	True
primary rainbow	ğŸŒˆ	True
fugu fish	ğŸ¡	True
waving hand sign	ğŸ‘‹	True
flagstick	ğŸš©	True
hospital	ğŸ¥	True
thumbs down sign	ğŸ‘	True
waning	ğŸŒ–	True
keycap digit four	4ï¸âƒ£	True
regional indicator symbol letters kg	ğŸ‡°ğŸ‡¬	True
olive toned girl	ğŸ‘§ğŸ½	True
tony	ğŸ…	True
church wedding	ğŸ’’	True
tomato	ğŸ…	True
red flag	ğŸš©	True
anchor	âš“ï¸	True
h20	ğŸš±	True
heavy heart exclamation mark ornament	â£	True
cockerel	ğŸ“	True
five	ğŸŒŸ	True
light brown police officer	ğŸ‘®ğŸ¼	True
observing	ğŸ‘	True
regional indicator symbol letters om	ğŸ‡´ğŸ‡²	True
salsa dancer	ğŸ’ƒ	True
regular potato	ğŸ¥”	True
teeth	ğŸ‘¹	True
astrology	â™ˆï¸	True
chick hatching	ğŸ£	True
jolly	ğŸ»	True
flower	ğŸ´	True
japanese	ğŸ’´	True
jar	ğŸº	True
ophiuchus	â›	True
regional indicator symbol letters ge	ğŸ‡¬ğŸ‡ª	True
werewolves	ğŸŒ•	True
worried face	ğŸ˜Ÿ	True
convenient	ğŸ±	True
scroll	ğŸ“œ	True
core	ğŸ	True
guamanian flag	ğŸ‡¬ğŸ‡º	True
white man with turban	ğŸ‘³ğŸ»	True
greek	â™’	True
banknote with yen sign	ğŸ’´	True
deeper brown baby	ğŸ‘¶ğŸ¾	True
deeper brown guardsman	ğŸ’‚ğŸ¾	True
flag for brazil	ğŸ‡§ğŸ‡·	True
regional indicator symbol letters bb	ğŸ‡§ğŸ‡§	True
cinema screen	ğŸ¦	True
mosque	ğŸ•Œ	True
mono	ğŸš	True
gold heart	ğŸ’›	True
santa	ğŸ…	True
regional indicator symbol letters ca	ğŸ‡¨ğŸ‡¦	True
wow	ğŸ’¥	True
kiss	ğŸ˜½	True
astrology	â™‹ï¸	True
accommodation	ğŸ¨	True
electric train	ğŸš†	True
plant	ğŸŒ¿	True
frames	ğŸ‘“	True
french flag	ğŸ‡«ğŸ‡·	True
children	ğŸˆ	True
grandpa	ğŸ‘´	True
pastels	ğŸ¨	True
england	ğŸ‰	True
light brown ok hand sign	ğŸ‘ŒğŸ¼	True
emergency	ğŸš¨	True
hen	ğŸ”	True
estonian flag	ğŸ‡ªğŸ‡ª	True
wings	ğŸ‘¼	True
sake	ğŸ¶	True
banknote	ğŸ’·	True
crawl	ğŸš¼	True
sport	ğŸˆ	True
circus	ğŸª	True
icon	ğŸ‘¤	True
potable	ğŸš°	True
flag for croatia	ğŸ‡­ğŸ‡·	True
paper doily	ğŸ’®	True
flag for tonga	ğŸ‡¹ğŸ‡´	True
draw	ğŸ¨	True
roadwork	ğŸš§	True
two flags	ğŸŒ	True
regional indicator symbol letters ga	ğŸ‡¬ğŸ‡¦	True
light brown girl	ğŸ‘§ğŸ¼	True
storage	ğŸ’¾	True
india	ğŸ‘³	True
studio microphone	ğŸ™	True
regional indicator symbol letters vi	ğŸ‡»ğŸ‡®	True
globe	ğŸŒ	True
mother	ğŸ¼	True
pedal	ğŸš²	True
transportation	ğŸš²	True
heavy multiplication x	âœ–ï¸	True
galaxy	ğŸŒŒ	True
reception bars	ğŸ“¶	True
cock	ğŸ“	True
kiss	ğŸ’Œ	True
barbecue	ğŸ–	True
deeper brown swimmer	ğŸŠğŸ¾	True
city	ğŸš•	True
one bump camel	ğŸª	True
entertainment	ğŸ¢	True
lion	â™Œï¸	True
electric	ğŸ¸	True
campervan	ğŸš™	True
banknote with dollar sign	ğŸ’µ	True
theater	ğŸ‘¹	True
white heavy check mark	âœ…	True
smiling face with open mouth and cold sweat	ğŸ˜…	True
drooping flower	ğŸ¥€	True
anguished face	ğŸ˜§	True
japanese lantern	ğŸ®	True
kimono	ğŸ‘˜	True
zodiac	â™	True
spicy	ğŸŒ¶	True
two men holding hands	ğŸ‘¬	True
constellation	â™‰ï¸	True
vocal	ã€½ï¸	True
scooter	ğŸ›´	True
up down arrow	â†•ï¸	True
bird	ğŸ¦	True
zodiac	â™‹ï¸	True
frown	ğŸ˜	True
regional indicator symbol letters cz	ğŸ‡¨ğŸ‡¿	True
kebab	ğŸ¢	True
blush	ğŸ˜³	True
ski	ğŸš¤	True
no	ğŸš³	True
smiley	ğŸ˜€	True
sound	ğŸµ	True
greek	â™	True
visa card	ğŸ’³	True
banknote	ğŸ’´	True
black baby	ğŸ‘¶ğŸ¿	True
cruise ship	ğŸš¢	True
pine decoration	ğŸ	True
fire	ğŸ’¥	True
regional indicator symbol letters vc	ğŸ‡»ğŸ‡¨	True
roasted sweet potato	ğŸ 	True
go	ğŸš¥	True
boat	ğŸš¢	True
psychic	ğŸ”®	True
speaker with three sound waves	ğŸ”Š	True
spanner	ğŸ”§	True
color	ğŸŒ…	True
school bus	ğŸšŒ	True
roasted	ğŸŒ°	True
playful	ğŸ˜œ	True
white person with folded hands	ğŸ™ğŸ»	True
olive toned baby angel	ğŸ‘¼ğŸ½	True
crazy face	ğŸ˜œ	True
chinese camel	ğŸ«	True
stars	â™ï¸	True
birth	ğŸ‚	True
private eye	ğŸ•µ	True
face with straight mouth	ğŸ˜‘	True
endure	ğŸ˜£	True
regional indicator symbol letters ru	ğŸ‡·ğŸ‡º	True
keep it 100	ğŸ’¯	True
flag for belarus	ğŸ‡§ğŸ‡¾	True
stars	â™‹	True
cloud with rain	ğŸŒ§	True
hand wave	ğŸ‘‹	True
hourglass	âŒ›ï¸	True
adventure	ğŸ’	True
vertical traffic light	ğŸš¦	True
cute tiger	ğŸ¯	True
cute	ğŸ‘¿	True
person with blond hair	ğŸ‘±	True
seed	ğŸŒ¾	True
gyro	ğŸš	True
scales	â™	True
football	âš½	True
cream	ğŸ®	True
crap	ğŸ’©	True
sake	ğŸ®	True
annoyed	ğŸ™	True
music	ğŸ§	True
twilight	ğŸŒ•	True
university	ğŸ«	True
food	ğŸ„	True
push bike	ğŸš²	True
constellation	â›	True
water	â™’ï¸	True
big wheel	ğŸ¡	True
butchers knife	ğŸ”ª	True
black nail polish	ğŸ’…ğŸ¿	True
sad	ğŸ™	True
flag for guinea	ğŸ‡¬ğŸ‡³	True
occidental	ğŸ‘±	True
baby chick	ğŸ¥	True
keyboard	âŒ¨	True
person on bike	ğŸš´	True
ç”³	ğŸˆ¸	True
open padlock	ğŸ”“	True
currency	ğŸ’²	True
binder	ğŸ“’	True
nori	ğŸ™	True
umbrella	â˜”	True
white clapping hands sign	ğŸ‘ğŸ»	True
triangular ruler	ğŸ“	True
sunset over buildings	ğŸŒ‡	True
gas pump	â›½	True
circle	â­•	True
gemini	â™Š	True
emergency	ğŸ†˜	True
black circle for record	âº	True
classical building	ğŸ›	True
short	ğŸ°	True
cloudless	ğŸŒƒ	True
humpback whale	ğŸ‹	True
grape	ğŸ‡	True
poles	ğŸ¿	True
regional indicator symbol letters cg	ğŸ‡¨ğŸ‡¬	True
cue	ğŸ±	True
wonder	ğŸ’­	True
left fist bump	ğŸ¤›	True
regional indicator symbol letters rw	ğŸ‡·ğŸ‡¼	True
spooky	ğŸƒ	True
gamble	ğŸ²	True
hushed face	ğŸ˜¯	True
yeast	ğŸº	True
railcar	ğŸšƒ	True
moon	ğŸŒ›	True
drop	ğŸ’§	True
game	ğŸ²	True
day dream	ğŸ’­	True
manga meat	ğŸ–	True
notifications	ğŸ”•	True
cheese	ğŸŒš	True
small airplane	ğŸ›©	True
confused	ğŸ˜•	True
hot	ğŸ«	True
funicular	ğŸš	True
planet	ğŸŒ	True
money	ğŸ’²	True
deeper brown fisted hand sign	ğŸ‘ŠğŸ¾	True
silly	ğŸ˜›	True
kidding	ğŸ˜œ	True
mahjong tile	ğŸ€„	True
heavy large circle	â­•ï¸	True
white white right pointing backhand index	ğŸ‘‰ğŸ»	True
acting	ğŸ­	True
lather	ğŸ›	True
black person bowing deeply	ğŸ™‡ğŸ¿	True
dessert	ğŸª	True
waxing	ğŸŒ’	True
anticlockwise downwards and upwards open circle arrows	ğŸ”„	True
cruise	ğŸš¢	True
space	ğŸŒƒ	True
mad	ğŸ˜ 	True
facsimile	ğŸ“ 	True
orange sky city	ğŸŒ†	True
capricorn	â™‘	True
smiling poop	ğŸ’©	True
wild cherry	ğŸ’	True
bball	ğŸ€	True
coaster	ğŸ¢	True
deeper brown haircut	ğŸ’‡ğŸ¾	True
cheese	ğŸŒ“	True
volcano	ğŸŒ‹	True
halfpipe	ğŸ‚	True
page with curl	ğŸ“ƒ	True
massage	ğŸ™‡	True
wind	ğŸƒ	True
eye in speech bubble	ğŸ‘â€ğŸ—¨	True
cold	ğŸ¦	True
keycap asterisk	*âƒ£	True
flower	ğŸ	True
scorpio	â™	True
hike	ğŸ’	True
balloon	ğŸ’¬	True
crime	ğŸš“	True
cable	ğŸš¡	True
fruit	ğŸ¹	True
open mailbox	ğŸ“¬	True
black medium small square	â—¾	True
regional indicator symbol letters hr	ğŸ‡­ğŸ‡·	True
luck	ğŸ	True
construction worker	ğŸ‘·	True
greek	â™“ï¸	True
face with cold sweat	ğŸ˜“	True
ox	ğŸ‚	True
surfer	ğŸ„	True
police cars revolving light	ğŸš¨	True
celebration	ğŸˆ	True
sign	â™‰ï¸	True
ewe	ğŸ‘	True
teacher	ğŸ’®	True
leo	â™Œ	True
service	ğŸš•	True
wind blowing face	ğŸŒ¬	True
happy face	ğŸ˜ƒ	True
love	ğŸ’Œ	True
film projector	ğŸ“½	True
avocado	ğŸ¥‘	True
stars	â™‹ï¸	True
deeper brown nose	ğŸ‘ƒğŸ¾	True
turkey	ğŸ”	True
regional indicator symbol letters et	ğŸ‡ªğŸ‡¹	True
sky	ğŸŒ™	True
painting	ğŸ¨	True
house with garden	ğŸ¡	True
violet	ğŸ’œ	True
helmet with white cross	â›‘	True
dito medio	ğŸ–•	True
boogy	ğŸ’ƒ	True
gust of wind	ğŸ’¨	True
alpine	ğŸ‚	True
flag for venezuela	ğŸ‡»ğŸ‡ª	True
corn	ğŸŒ½	True
food	ğŸ˜	True
old house	ğŸš	True
symbols	ğŸ”£	True
haitian flag	ğŸ‡­ğŸ‡¹	True
surprise	ğŸ˜¯	True
pregnancy	ğŸ¤°	True
pill	ğŸ’Š	True
cowgirl	ğŸ	True
red rose	ğŸŒ¹	True
doner kebab	ğŸ¥™	True
cow face	ğŸ®	True
clock face nine oclock	ğŸ•˜	True
city	ğŸš	True
cherry	ğŸ’	True
constellation	â™‹	True
kids	ğŸ	True
surf	ğŸŒŠ	True
proof	ğŸ«	True
high heels	ğŸ‘ 	True
sleepy	ğŸ˜«	True
rail	ğŸšŸ	True
pained face	ğŸ˜§	True
olive toned person with folded hands	ğŸ™ğŸ½	True
blossoming flower	ğŸŒ¼	True
regional indicator symbol letters bf	ğŸ‡§ğŸ‡«	True
avatar	ğŸš¹	True
wii u	ğŸ®	True
ferry	â›´	True
police officer	ğŸ‘®	True
city building	ğŸ¢	True
rain	ğŸŒ‚	True
milk	ğŸƒ	True
flag for monaco	ğŸ‡²ğŸ‡¨	True
sign	â™‘ï¸	True
keycap digit seven	7âƒ£ï¸	True
flag for algeria	ğŸ‡©ğŸ‡¿	True
achievement	ğŸ†	True
devil horns	ğŸ˜ˆ	True
artist	ğŸ™€	True
cookie	ğŸª	True
mr whippy	ğŸ¦	True
sexy	ğŸ™	True
sob	ğŸ˜­	True
person on bike	ğŸšµ	True
black face massage	ğŸ’†ğŸ¿	True
older woman	ğŸ‘µ	True
sadface	ğŸ˜	True
sign	â™’ï¸	True
light	ğŸ’¡	True
digger	ğŸšœ	True
red crab	ğŸ¦€	True
listen	ğŸ§	True
mouse	ğŸ	True
sound	ğŸ™‰	True
werewolves	ğŸŒ	True
bus stop	ğŸš	True
naughty	ğŸ…	True
finger point	ğŸˆ¯	True
boys holding hands	ğŸ‘¬	True
last	ğŸŒœ	True
television	ğŸ“º	True
ship	âš“	True
bleeper	ğŸ“Ÿ	True
golf club	ğŸŒ	True
regional indicator symbol letters ps	ğŸ‡µğŸ‡¸	True
compassion	ğŸ’œ	True
fiddle	ğŸ»	True
us virgin islander flag	ğŸ‡»ğŸ‡®	True
sos	ğŸ†˜	True
pudding	ğŸ®	True
billy	ğŸ	True
leaf	ğŸ	True
flag for bolivia	ğŸ‡§ğŸ‡´	True
harbor	âš“ï¸	True
butterfly	ğŸŠ	True
face with open mouth and cold sweat	ğŸ˜°	True
cute	ğŸ¼	True
exasperated	ğŸ˜°	True
hamburger	ğŸ”	True
serve	ğŸ¨	True
packing	ğŸ’	True
plumbing	ğŸš½	True
dead flower	ğŸ¥€	True
flag for argentina	ğŸ‡¦ğŸ‡·	True
white raised fist	âœŠğŸ»	True
deeper brown police officer	ğŸ‘®ğŸ¾	True
angry	ğŸ˜ 	True
bengal tiger	ğŸ…	True
lesbian couple	ğŸ‘­	True
olive toned ear	ğŸ‘‚ğŸ½	True
regional indicator symbol letters ma	ğŸ‡²ğŸ‡¦	True
face savouring delicious food	ğŸ˜‹	True
regional indicator symbol letters by	ğŸ‡§ğŸ‡¾	True
flag for qatar	ğŸ‡¶ğŸ‡¦	True
summer	ğŸ”…	True
sky	ğŸŒ 	True
whale	ğŸ‹	True
sparkly heart	ğŸ’–	True
deeper brown mountain bicyclist	ğŸšµğŸ¾	True
file cabinet	ğŸ—„	True
race	ğŸƒ	True
deeper brown happy person raising one hand	ğŸ™‹ğŸ¾	True
mouth	ğŸ˜¶	True
full	ğŸŒ•	True
tired	ğŸ˜ª	True
flower	ğŸŒ¼	True
congratulations	ğŸŠ	True
no water	ğŸš±	True
flush	ğŸš¾	True
olive toned man with turban	ğŸ‘³ğŸ½	True
persevering face	ğŸ˜£	True
venezuelan flag	ğŸ‡»ğŸ‡ª	True
asian lantern	ğŸ®	True
night	ğŸŒ”	True
building construction	ğŸ—	True
transport	ğŸš	True
roller coaster	ğŸ¢	True
regional indicator symbol letters no	ğŸ‡³ğŸ‡´	True
homosexual	ğŸ‘­	True
japanese	ğŸ£	True
omkara	ğŸ•‰	True
insect	ğŸ›	True
keycap digit two	2ï¸âƒ£	True
blood type ab	ğŸ†	True
flag for libya	ğŸ‡±ğŸ‡¾	True
santa	ğŸ„	True
can	ğŸš¯	True
sweat	ğŸ˜°	True
hand with first and second fingers crossed	ğŸ¤	True
basin	ğŸ›€	True
silhouette	ğŸ‘¥	True
regional indicator symbol letters gm	ğŸ‡¬ğŸ‡²	True
revolving hearts	ğŸ’	True
flag for liberia	ğŸ‡±ğŸ‡·	True
olive toned waving hand sign	ğŸ‘‹ğŸ½	True
tee shirt	ğŸ‘•	True
celebration	ğŸ	True
open folder	ğŸ“‚	True
flag for mali	ğŸ‡²ğŸ‡±	True
help	ğŸš”	True
silhouettes	ğŸ‘¥	True
cat	ğŸˆ	True
person raising both hands in celebration	ğŸ™Œ	True
white surfer	ğŸ„ğŸ»	True
loo	ğŸš½	True
regional indicator symbol letters pg	ğŸ‡µğŸ‡¬	True
timid lion	ğŸ¦	True
white information desk person	ğŸ’ğŸ»	True
flag for denmark	ğŸ‡©ğŸ‡°	True
kiss	ğŸ’	True
halloween	ğŸ‘»	True
rail	ğŸš…	True
mad face	ğŸ˜¡	True
official	ğŸ›‚	True
olive toned clapping hands sign	ğŸ‘ğŸ½	True
playful	ğŸ˜	True
knee high boots	ğŸ‘¢	True
celebrate	ğŸ‚	True
heart	ğŸ’Œ	True
minibus	ğŸš	True
white right pointing backhand index	ğŸ‘‰	True
noodles	ğŸ	True
scared	ğŸ˜¨	True
granny smith apple	ğŸ	True
radio button	ğŸ”˜	True
light brown person with blond hair	ğŸ‘±ğŸ¼	True
cloud with lightning	ğŸŒ©	True
flag for afghanistan	ğŸ‡¦ğŸ‡«	True
sky	ğŸŒƒ	True
pedal	ğŸš´	True
flag for liechtenstein	ğŸ‡±ğŸ‡®	True
flag for latvia	ğŸ‡±ğŸ‡»	True
puckered	ğŸ˜š	True
alcohol	ğŸ·	True
graduation	ğŸ“	True
artist	ğŸ¨	True
firework sparkler	ğŸ‡	True
soothing	ğŸ	True
block of chocolate	ğŸ«	True
shampoo	ğŸ›€	True
fish	ğŸ 	True
silent	ğŸ˜¶	True
zero width joiner	â€	True
wink face	ğŸ˜‰	True
beating heart	ğŸ’“	True
mouth	ğŸ™Š	True
last quarter moon symbol	ğŸŒ—	True
wild pig	ğŸ—	True
regional indicator symbol letters do	ğŸ‡©ğŸ‡´	True
confused face	ğŸ˜•	True
spiritual	ğŸ	True
bubble	ğŸ›	True
impact	ğŸ’¥	True
children	ğŸ	True
ribbon	ğŸ€	True
gas	â›½ï¸	True
x arms	ğŸ™…	True
softball	âš¾	True
disk	ğŸ’¾	True
pout	ğŸ˜¾	True
desert	ğŸŒµ	True
flag for tajikistan	ğŸ‡¹ğŸ‡¯	True
flag for azerbaijan	ğŸ‡¦ğŸ‡¿	True
light brown baby	ğŸ‘¶ğŸ¼	True
astrology	â›	True
black rightwards arrow	â¡ï¸	True
water	ğŸš±	True
constellation	â™‘ï¸	True
happy cat	ğŸ˜º	True
flag for tunisia	ğŸ‡¹ğŸ‡³	True
face	ğŸ¼	True
construction	ğŸšœ	True
snowing snowman	â˜ƒ	True
night	ğŸŒ‰	True
diaper	ğŸš¼	True
caution	ğŸš¸	True
serious	ğŸ˜”	True
constellation	â™	True
passion	â¤ï¸	True
encouragement	ğŸ‘	True
happiness	ğŸ’›	True
ears	ğŸ§	True
sorrowful	ğŸ˜”	True
basketball and hoop	ğŸ€	True
row	ğŸš£	True
frying pan	ğŸ³	True
regional indicator symbol letters mm	ğŸ‡²ğŸ‡²	True
umbrella on ground	â›±	True
socially awkward penguin	ğŸ§	True
latin cross	âœ	True
spice	ğŸŒ¿	True
cow	ğŸ„	True
vision	ğŸ™ˆ	True
pack	ğŸ’	True
face with cowboy hat	ğŸ¤ 	True
south east arrow	â†˜ï¸	True
apple watch	âŒš	True
toilet	ğŸš¾	True
bath	ğŸ›€	True
prostitution	ğŸ©	True
flag for hong kong	ğŸ‡­ğŸ‡°	True
aries	â™ˆ	True
tool	ğŸ”¨	True
triangle rice	ğŸ™	True
stride	ğŸš¶	True
blessing	ğŸ	True
sign	â™Šï¸	True
handset	ğŸ“	True
presents	ğŸ„	True
flag for madagascar	ğŸ‡²ğŸ‡¬	True
red mask	ğŸ‘º	True
cap	ğŸ©	True
bathroom sign	ğŸš»	True
taurus	â™‰	True
assignment	ğŸ’®	True
picture	ğŸ¦	True
light brown rowboat	ğŸš£ğŸ¼	True
flag for iran	ğŸ‡®ğŸ‡·	True
flag for cambodia	ğŸ‡°ğŸ‡­	True
flag for moldova	ğŸ‡²ğŸ‡©	True
red book	ğŸ“•	True
olive toned runner	ğŸƒğŸ½	True
world wide web	ğŸŒ	True
shirt and tie	ğŸ‘”	True
relief	ğŸ˜Œ	True
water	ğŸ«	True
ocean wave	ğŸŒŠ	True
respectful	ğŸ’›	True
spectrum	ğŸŒˆ	True
cash	ğŸ’¸	True
microphone	ğŸ¤	True
vapid	ğŸ˜‘	True
ant	ğŸœ	True
queen	ğŸ‘‘	True
frustration	ğŸ‘º	True
wild boar	ğŸ—	True
grapes	ğŸ‡	True
waving black flag	ğŸ´	True
new	ğŸ	True
blue	ğŸ’™	True
fishing	ğŸ£	True
mystify	ğŸ˜–	True
appetizer	ğŸŒ	True
first	ğŸŒ›	True
curly loop	â°	True
couch	ğŸ›‹	True
regional indicator symbol letters is	ğŸ‡®ğŸ‡¸	True
stuffed flatbread	ğŸ¥™	True
phase	ğŸŒ	True
bellhop bell	ğŸ›	True
flag for colombia	ğŸ‡¨ğŸ‡´	True
thumbs up	ğŸ‘	True
crown	ğŸ‘‘	True
negative squared latin capital letter a	ğŸ…°ï¸	True
tar	ğŸš¬	True
deeper brown person with pouting face	ğŸ™ğŸ¾	True
japan	ğŸ’´	True
sight	ğŸ™ˆ	True
royalty	ğŸ°	True
hatching chick	ğŸ£	True
white woman	ğŸ‘©ğŸ»	True
water closet	ğŸš¾	True
pine tree	ğŸŒ²	True
zig zag bubble	ğŸ—¯	True
anger	ğŸ˜¡	True
aubergine	ğŸ†	True
stinky	ğŸ‘ƒ	True
hearts	ğŸ’	True
residence	ğŸ°	True
clingy	ğŸ’š	True
light brown raised fist	âœŠğŸ¼	True
pool	ğŸŠ	True
olive toned woman	ğŸ‘©ğŸ½	True
nauruan flag	ğŸ‡³ğŸ‡·	True
smirking	ğŸ˜	True
mexican flag	ğŸ‡²ğŸ‡½	True
empty and available	ğŸˆ³	True
loan	ğŸ’³	True
carnival	ğŸª	True
triumph	ğŸ˜¤	True
turkey leg	ğŸ—	True
fish	ğŸ£	True
pick	â›	True
plewds	ğŸ’¦	True
desk calendar	ğŸ“†	True
male	ğŸ“	True
bug	ğŸ›	True
transport	ğŸš	True
greek	â™ˆ	True
snow	â„ï¸	True
dessert	ğŸ¦	True
bird flu	ğŸ˜·	True
details	ğŸ”	True
kaaba	ğŸ•‹	True
hear	ğŸ™‰	True
organ	ğŸ¹	True
regional indicator symbol letters ua	ğŸ‡ºğŸ‡¦	True
flag for new zealand	ğŸ‡³ğŸ‡¿	True
keycap digit nine	9âƒ£ï¸	True
credit	ğŸ’³	True
regional indicator symbol letters sc	ğŸ‡¸ğŸ‡¨	True
america	ğŸŒ	True
uk flag	ğŸ‡¬ğŸ‡§	True
money	ğŸ’¸	True
white man	ğŸ‘¨ğŸ»	True
heart with ribbon	ğŸ’	True
smiling face with halo	ğŸ˜‡	True
pig	ğŸ½	True
cheering megaphone	ğŸ“£	True
cheese	ğŸŒ˜	True
sweet	ğŸ­	True
gifts	ğŸ„	True
fallen leaf	ğŸ‚	True
smile	ğŸ˜€	True
friendship	ğŸ¼	True
winery	ğŸ·	True
longevity	ğŸ	True
regional indicator symbol letters bs	ğŸ‡§ğŸ‡¸	True
no entry sign	ğŸš«	True
speech balloon	ğŸ’¬	True
pink umbrella	ğŸŒ‚	True
circled ideograph advantage	ğŸ‰	True
movie camera	ğŸ¥	True
foreign	ğŸ›ƒ	True
clockwise downwards and upwards open circle arrows	ğŸ”ƒ	True
shadow	ğŸ‘¥	True
reptile	ğŸ¢	True
nails	ğŸ’…	True
flag for pakistan	ğŸ‡µğŸ‡°	True
bike pedal	ğŸš³	True
airing of grievances	ğŸ˜¤	True
say	ğŸ™Š	True
red pin	ğŸ“	True
djibouti flag	ğŸ‡©ğŸ‡¯	True
dance	ğŸ’ƒ	True
astrology	â™‰	True
phone call	ğŸ“²	True
regional indicator symbol letters kw	ğŸ‡°ğŸ‡¼	True
cake	ğŸ°	True
regional indicator symbol letters lv	ğŸ‡±ğŸ‡»	True
turkey	ğŸ¦ƒ	True